Wo, Wo, Wo, Wo, Wo, Wo, Wo, Wo, Wo, Wo, Wo, Wo, Wo, Wo, Wo, Wo, Wo, Wo, Wo, Wo, Wo, Wo, Wo, Wo, Wo, Ww, Ww, Ww, Ww, Gg^Fp, Gg^Fp, Ww, Ww, Ww, Ww, Ww, Ww, Ww, Ww, Ww, Ww, Ww, Ww, Ww, Ww, Wo, Wo, Wo, Wo, Wo, Wo, Wo, Wo, Wo, Wo, Wo, Wo, Wo, Wo, Wo, Wo, Wo, Wo, Wo, Wo, Wo, Wo, Wo, Wo, Wo, Wo, Wo
Wo, Wo, Wo, Wo, Wo, Wo, Wo, Wo, Wo, Wo, Wo, Wo, Wo, Wo, Wo, Wo, Wo, Wo, Wo, Wo, Wo, Wo, Wo, Wo, Wo, Ww, Ww, Ww, Ww, Gg^Fp, Gg^Fp, Gg^Fp, Ww, Gg^Fp, Gg^Fp, Gg^Fp, Gg^Fp, Ww, Ww, Ww, Gg, Ww, Ww, Ww^Vm, Ww, Wo, Wo, Wo, Wo, Wo, Wo, Wo, Wo, Wo, Wo, Wo, Wo, Wo, Wo, Wo, Wo, Wo, Wo, Wo, Wo, Wo, Wo, Wo, Wo, Wo, Wo, Wo
Wo, Wo, Wo, Wo, Wo, Wo, Wo, Wo, Wo, Wo, Wo, Wo, Wo, Wo, Wo, Wo, Wo, Wo, Wo, Wo, Wo, Wo, Wo, Wo, Ww, Ww, Ww, Gg^Fp, Gg^Fp, Gg^Fp, Gg^Fp, Ww, Ww, Ww, Gg^Fp, Gg^Fp, Gg^Fp, Gg, Gg, Gg, Gg, Gg, Gg, Ww, Ww, Ww, Wo, Wo, Wo, Ww, Wo, Wo, Wo, Wo, Wo, Wo, Wo, Wo, Wo, Wo, Wo, Wo, Wo, Wo, Wo, Wo, Wo, Wo, Wo, Wo, Wo, Wo
Wo, Wo, Wo, Wo, Wo, Wo, Wo, Wo, Wo, Wo, Wo, Wo, Wo, Wo, Wo, Wo, Wo, Wo, Wo, Wo, Wo, Wo, Wo, Wo, Ww, Gg^Fp, Gg^Fp, Gg^Fp, Gg^Fp, Gg, Gg, Gg, Gg, Gg, Gg, Gg, Gg, Gg, Gg, Gg, Ch, Ch, Ch, Gg, Gg^Fp, Ww, Ww, Ww, Ww, Ww, Ww, Ww, Wo, Wo, Wo, Wo, Wo, Wo, Wo, Wo, Wo, Wo, Wo, Wo, Wo, Wo, Wo, Wo, Wo, Wo, Wo, Wo
Wo, Wo, Wo, Wo, Wo, Wo, Wo, Wo, Wo, Wo, Wo, Wo, Wo, Wo, Wo, Wo, Wo, Wo, Wo, Wo, Wo, Wo, Wo, Ww, Gg^Fp, Gg^Fp, Gg^Fp, Gg^Fp, Gg, Gg, Rr, Rr, Rr, Gg, Gg, Gg, Gg, Gg, Rr, Rr, Ch, 7 Kh, Ch, Gg, Gg^Fp, Gg^Fp, Gg^Fp, Ww, Ww, Ww^Vm, Ww, Ww, Ww, Ww, Wo, Wo, Wo, Wo, Wo, Wo, Wo, Wo, Wo, Wo, Wo, Wo, Wo, Wo, Wo, Wo, Wo, Wo
Wo, Wo, Wo, Wo, Wo, Wo, Wo, Wo, Wo, Wo, Wo, Wo, Wo, Wo, Wo, Wo, Wo, Wo, Wo, Wo, Wo, Wo, Wo, Ww, Gg, Gg^Fp, Gg^Fp, Gg^Fp, Gg^Vh, Rr, Gg^Vh, Gg, Gg, Rr, Rr, Gg, Gg, Gg, Rr, Gg, Gg, Ch, Gg, Gg, Gg^Fp, Gg^Fp, Gg, Ww, Ww, Ww, Ww, Ww, Ww, Ww, Ww, Wo, Wo, Wo, Wo, Wo, Wo, Wo, Wo, Wo, Wo, Wo, Wo, Wo, Wo, Wo, Wo, Wo
Wo, Wo, Wo, Wo, Wo, Wo, Wo, Wo, Wo, Wo, Wo, Wo, Wo, Wo, Wo, Wo, Wo, Wo, Wo, Wo, Wo, Wo, Ww, Gg^Fp, Gg, Gg^Fp, Gg^Fp, Gg, Rr, Rr, Gg, Gg, Gg, Gg, Gg^Fp, Rr, Rr, Rr, Gg^Vh, Gg, Gg, Gg, Gg, Gg, Gg, Gg^Fp, Gg, Gg, Ww, Ww, Gg, Ww, Ww, Ww, Ww, Wo, Wo, Wo, Wo, Wo, Wo, Wo, Wo, Wo, Wo, Wo, Wo, Wo, Wo, Wo, Wo, Wo
Wo, Wo, Wo, Wo, Wo, Wo, Wo, Wo, Wo, Wo, Wo, Wo, Wo, Wo, Wo, Wo, Wo, Wo, Wo, Wo, Wo, Ww, Ww, Gg^Fp, Gg, Gg, Gg, Gg, Rr, Gg, Gg, Gg, Gg, Gg, Gg, Gg^Fp, Gg, Hh, Gg, Gg, Gg, Gg^Fp, Gg, Gg^Vh, Gg, Gg^Fp, Gg, Gg, Gg, Ww, Ww, Gg, Gg, Ww, Ww, Ww, Ww, Ww, Ww, Ww, Wo, Wo, Wo, Wo, Wo, Wo, Wo, Wo, Wo, Wo, Wo, Wo
Wo, Wo, Wo, Wo, Wo, Wo, Wo, Wo, Wo, Wo, Wo, Wo, Wo, Wo, Wo, Wo, Wo, Wo, Wo, Wo, Wo, Ww, Gg^Fp, Gg^Fp, Gg, Gg, Gg, Gg, Rr, Gg, Gg^Fp, Gg^Fp, Gg^Fp, Gg, Gg, Hh, Hh, Hh, Hh, Hh, Gg, Gg, Gg, Gg, Gg, Gg, Gg, Gg, Gg, Gg, Gg, Gg, Ww, Ww, Ww, Ww, Ww, Gg, Ww, Ww, Ww, Wo, Wo, Wo, Wo, Wo, Wo, Wo, Wo, Wo, Wo, Wo
Wo, Wo, Wo, Wo, Wo, Wo, Wo, Wo, Wo, Wo, Wo, Wo, Wo, Wo, Wo, Wo, Wo, Wo, Wo, Ww, Ww, Gg^Fp, Gg^Fp, Gg, Gg, Gg, Rr, Rr, Gg, Gg^Fp, Gg^Fp, Gg^Fp, Gg^Fp, Gg^Fp, Hh, Hh, Hh, Hh, Hh, Hh, Gg, Gg, Gg, Gg, Gg, Gg, Gg, Gg, Gg, Gg, Gg, Gg, Gg, Gg, Ww, Ww, Ww, Ww, Ww, Ww, Ww, Ww, Wo, Wo, Wo, Wo, Wo, Wo, Wo, Wo, Wo, Wo
Wo, Wo, Wo, Wo, Wo, Wo, Wo, Wo, Wo, Wo, Wo, Wo, Wo, Wo, Wo, Wo, Wo, Ww, Ww, Ww, Gg, Gg^Vh, Rr, Gg, Gg^Vh, Rr, Gg, Gg, Gg, Gg^Fp, Gg^Fp, Gg^Fp, Gg^Fp, Gg^Fp, Hh, Hh, Hh, Hh, Hh, Hh, Gg^Fp, Gg, Gg, Gg, Gg, Gg, Gg, Gg, Gg, Gg, Gg, Gg, Gg^Ve, Gg^Fp, Gg^Fp, Gg^Fp, Ww, Ww, Ww, Ww, Ww, Ww, Ww, Wo, Wo, Wo, Wo, Wo, Wo, Wo, Wo, Wo
Wo, Wo, Wo, Wo, Wo, Wo, Wo, Wo, Wo, Wo, Wo, Wo, Wo, Wo, Wo, Wo, Ww, Gg^Vh, Gg^Fp, Gg^Fp, Rr, Rr, Gg, Rr, Rr, Rr, Gg, Gg, Gg, Gg, Gg, Gg, Gg^Fp, Gg^Fp, Gg, Gg, Hh, Hh, Hh, Gg^Fp, Gg^Fp, Gg, Gg, Gg, Gg, Gg, Gg, Gg, Gg, Gg, Gg, Gg^Fp, Gg^Fp, Gg^Fp, Gg^Ve, Gg^Fp, Gg^Fp, Gg, Ww, Gg^Fms, Ww, Ww, Ww, Ww, Wo, Wo, Wo, Wo, Wo, Wo, Wo, Wo
Wo, Wo, Wo, Wo, Wo, Wo, Wo, Wo, Wo, Wo, Wo, Wo, Wo, Wo, Wo, Ww, Rr, Rr, Gg^Fp, Gg^Fp, Gg^Fp, Gg^Fp, Gg^Fp, Gg^Fp, Gg, Gg, Gg, Gg, Gg, Gg, Gg, Gg, Gg^Fp, Gg^Fp, Gg, Gg, Gg, Gg, Gg^Fp, Gg^Ve, Gg^Fp, Gg^Fp, Gg, Gg, Gg^Fp, Gg^Fp, Gg, Gg, Gg, Gg^Fp, Gg^Fp, Gg^Fp, Gg, Gg^Fp, Gg^Fp, Gg^Fp, Gg^Fp, Gg, Gg^Fms, Gg^Fms, Gg^Fms, Ww, Gg, Ww, Wo, Wo, Wo, Wo, Wo, Wo, Wo, Wo
Wo, Wo, Wo, Wo, Wo, Wo, Wo, Wo, Wo, Wo, Wo, Wo, Wo, Wo, Ch, Rr, Rr, Rr, Rr, Rr, Gg^Fp, Gg^Fp, Gg^Fp, Gg^Fp, Gg^Fp, Gg^Fp, Gg^Fp, Gg^Fp, Gg, Gg, Gg, Gg, Gg^Fp, Gg^Fp, Gg^Fp, Gg^Vh, Gg, Gg, Gg^Fp, Gg^Fp, Gg^Fp, Gg^Fp, Gg^Fp, Gg, Gg^Fp, Gg^Fp, Gg^Fp, Gg, Gg, Gg^Fp, Gg^Fp, Gg, Gg, Gg^Fp, Gg^Fp, Gg^Fp, Gg^Fp, Gg, Gg^Fms, Gg^Fms, Gg^Fms, Ww, Ww, Ww, Wo, Wo, Wo, Wo, Wo, Wo, Wo, Wo
Wo, Wo, Wo, Wo, Wo, Wo, Wo, Wo, Wo, Wo, Wo, Wo, Wo, Ww, Rr, Rr, Gg, Gg, Gg^Vh, Gg, Gg^Fp, Gg^Fp, Gg^Fp, Rr, Rr, Gg, Gg^Fp, Gg^Fp, Gg^Fp, Gg^Fp, Gg^Fp, Gg^Fp, Gg^Fp, Gg^Fp, Gg, Gg, Gg^Fp, Gg^Fp, Gg, Gg^Fp, Gg, Gg^Fp, Gg^Fp, Gg, Gg, Gg, Gg, Gg, Gg^Ve, Gg^Fp, Gg^Fp, Gg, Gg^Fp, Gg^Fp, Gg^Fp, Gg, Gg, Gg^Fms, Gg^Fms, Gg^Fms, Gg^Fms, Gg^Fms, Ww, Ww, Wo, Wo, Wo, Wo, Wo, Wo, Wo, Wo
Wo, Wo, Wo, Wo, Wo, Wo, Wo, Wo, Wo, Wo, Wo, Wo, Wo, Gg^Fp, Rr, Rr, Gg, Gg, Gg, Gg, Gg^Fp, Gg^Fp, Gg, Gg, Rr, Gg, Gg^Fp, Gg^Fp, Gg^Fp, Gg^Fp, Gg^Fp, Gg^Fp, Gg^Fp, Gg^Fp, Gg^Fp, Gg^Fp, Gg^Fp, Gg^Fp, Gg, Gg, Gg^Fp, Gg^Fp, Gg^Fp, Gg, Gg, Gg, Gg, Gg, Gg^Fp, Gg^Fp, Gg^Fp, Gg^Ve, Gg^Fp, Gg, Gg, Gg, Gg, Gg^Fms, Gg^Fms, Gg^Fms, Gg^Fms, Gg^Fms, Ww, Ww, Wo, Wo, Wo, Wo, Wo, Wo, Wo, Wo
Wo, Wo, Wo, Wo, Wo, Wo, Wo, Wo, Wo, Wo, Wo, Wo, Ww, Gg^Fp, Rr, Rr, Gg, Gg, Gg, Gg, Gg^Fp, Gg^Fp, Gg, Gg, Gg^Vh, Rr, Rr, Gg, Gg, Gg, Gg, Gg, Gg, Gg^Fp, Gg^Fp, Gg^Fp, Gg^Fp, Gg, Gg, Gg^Fp, Gg^Ve, Gg^Fp, Gg^Fp, Gg^Fp, Gg, Gg, Gg, Gg, Gg^Fp, Hh, Hh, Hh, Hh, Gg, Gg, Gg, Gg, Gg^Fms, Gg^Fms, Gg^Fms, Gg^Fms, Gg^Fms, Gg^Vh, Ww, Wo, Wo, Wo, Wo, Wo, Wo, Wo, Wo
Wo, Wo, Wo, Wo, Wo, Wo, Wo, Wo, Ww, Ww, Ww, Ww, Rr, Rr, Gg^Vh, Rr, Gg, Hh, Hh, Hh, Hh, Hh, Gg, Gg, Gg, Hh, Gg, Rr, Rr, Rr, Rr, Rr, Rr, Gg, Rr, Gg, Gg, Gg, Gg, Gg^Fp, Gg^Fp, Gg^Fp, Gg^Fp, Gg^Fp, Gg, Gg, Gg, Hh, Hh, Hh, Hh, Hh, Hh, Hh, Gg, Gg, Gg, Gg, Gg^Fms, Gg^Fms, Gg^Fms, Gg^Fms, Gg^Fms, Ww, Wo, Wo, Wo, Wo, Wo, Wo, Wo, Wo
Wo, Wo, Wo, Wo, Wo, Wo, Wo, Wo, Ww, Ww^Vm, Ww, Rr, Ch, Gg, Ch, Rr, Hh, Hh, Hh, Hh, Hh, Hh, Hh, Hh, Hh, Gg, Gg, Gg, Gg, Gg^Fp, Gg, Gg^Fp, Gg, Rr, Gg, Rr, Gg, Gg, Gg^Fp, Gg^Fp, Gg^Fp, Gg^Fp, Gg^Ve, Gg^Fp, Gg, Gg, Gg, Hh, Hh, Hh, Hh, Hh, Hh, Gg, Gg^Fp, Gg, Gg, Gg, Gg, Gg^Fms, Gg^Fms, Gg^Fms, Gg^Fms, Ww, Ww, Ww, Ww, Ww, Wo, Wo, Wo, Wo
Wo, Wo, Wo, Wo, Wo, Wo, Wo, Wo, Ww, Ww, Ww, Ch, Ch, Ch, 3 Kh, Hh, Ms, Ms, Ms, Ms, Ms, Hh, Hh, Hh, Hh, Gg, Gg, Gg, Gg, Gg^Fp, Gg^Fp, Gg^Fp, Gg, Gg, Gg, Rr, Rr, Gg, Gg^Fp, Gg^Fp, Gg^Fp, Gg^Fp, Gg^Fp, Gg, Gg, Gg, Gg, Hh, Hh, Hh, Hh, Hh, Hh, Hh, Gg^Fp, Gg^Fp, Gg, Gg, Gg, Gg, Gg, Ww, Ww, Ww, Ww, Ww, Ww, Ww, Ww, Wo, Wo, Wo
Wo, Wo, Wo, Wo, Wo, Wo, Wo, Wo, Ww, Ww, Ch, Ch, 2 Kh, Ch, Hh, Ms, Ms, Ms, Ms, Ms, Ms, Ms, Ms, Ms^Vhh, Hh, Gg^Vh, Gg, Gg, Gg, Gg, Gg^Fp, Gg^Ve, Gg^Fp, Gg, Gg, Gg, Gg, Rr, Rr, Gg, Gg, Gg, Gg, Gg, Gg, Gg, Gg, Hh, Hh, Hh, Hh, Hh, Hh, Hh, Gg^Fp, Gg^Fp, Gg, Gg, Gg, Gg, Gg, Gg, Ww, Ww, Ww, Ww, Ww, Ww, Ww, Ww, Ww, Wo
Wo, Wo, Wo, Wo, Wo, Wo, Wo, Ww, Ww, Ww, 1 Kh, Ch, Ch, Ch, Hh, Ms, Ms, Ms, Ms, Ms, Ms, Ms, Ms, Ms, Ms, Hh, Gg, Gg, Gg, Gg, Gg^Fp, Gg^Fp, Gg^Fp, Gg^Fp, Gg^Fp, Gg^Fp, Gg^Ve, Gg^Fp, Gg^Fp, Rr, Rr, Gg, Gg, Gg, Gg, Gg, Gg, Hh, Hh, Hh, Hh, Hh, Hh, Hh, Gg, Gg, Gg^Vh, Gg, Gg, Gg, Gg^Vh, Gg, Gg^Fp, Ww, Ww, Ww, Ww, Ww, Ww, Ww, Ww, Wo
Wo, Wo, Wo, Wo, Wo, Wo, Ww, Ww, Ww, Gg, Gg, Ch, Rr, Gg^Vh, Hh, Ms, Ms, Ms, Ms, Ms, Ms, Ms, Ms, Ms, Ms, Hh, Hh, Gg, Gg, Gg, Gg^Fp, Gg^Fp, Gg^Fp, Gg^Fp, Gg^Fp, Gg^Fp, Gg^Fp, Gg^Fp, Gg, Gg, Gg, Rr, Rr, Gg, Gg, Gg, Gg, Hh, Hh, Hh, Hh, Hh, Hh, Hh, Gg, Gg, Gg, Gg, Gg, Gg, Gg, Gg, Gg^Fp, Ww, Ww, Gg, Ww, Ww, Ww, Ww, Ww, Ww
Wo, Wo, Wo, Wo, Wo, Ww^Vm, Ww, Ww, Gg, Gg, Gg, Gg, Rr, Gg, Ms, Ms, Ms, Ms, Ms, Ms, Ms, Ms, Ms, Ms, Ms, Ms, Ms, Hh, Gg, Gg, Gg, Gg^Fp, Gg, Gg, Gg, Gg^Fp, Gg^Fp, Gg, Gg, Gg, Gg, Gg, Gg, Rr, Rr, Gg, Gg, Hh, Hh, Hh, Hh, Hh^Vhh, Hh, Gg^Fp, Gg^Fp, Gg^Fp, Gg, Gg, Gg, Ch, Ch, Ch, Gg^Fp, Ww, Gg, Gg, Gg, Ww, Ww, Ww, Ww, Ww
Wo, Wo, Wo, Wo, Wo, Ww, Ww, Ww, Gg, Gg^Vh, Gg, Gg, Rr, Hh, Ms, Ms, Ms, Ms, Ms, Ms, Ms, Ms, Ms, Ms, Ms, Ms, Ms, Hh, Hh, Gg, Gg, Gg^Fp, Gg^Fp, Gg, Gg, Gg^Ve, Gg^Fp, Gg^Fp, Gg^Fp, Gg, Gg, Gg, Gg, Gg, Rr, Gg, Gg, Hh, Hh, Hh, Hh, Hh, Hh, Gg^Fp, Gg^Ve, Gg^Fp, Gg, Gg, Gg, Ch, Kh, Ch, Ww, Gg, Gg, Gg, Ww, Ww, Gg^Fp, Gg^Fp, Ww, Ww
Wo, Wo, Wo, Wo, Wo, Wo, Ww, Ww, Gg^Fp, Gg^Fp, Gg, Gg, Rr, Hh, Hh, Ms, Ms, Ms, Ms, Ms, Ms, Ms, Ms, Ms, Ms, Ms, Ms, Ms, Hh, Gg, Gg, Gg, Gg^Fp, Gg^Fp, Gg^Fp, Gg^Fp, Gg, Gg^Fp, Gg^Fp, Gg^Fp, Gg^Fp, Gg^Fp, Gg^Fp, Gg, Gg, Rr, Gg^Fp, Hh, Hh, Hh, Hh, Hh, Hh, Gg^Fp, Gg^Fp, Gg^Fp, Gg^Fp, Gg, Rr, Rr, Ch, Gg, Gg, Gg, Gg, Gg, Ww, Ww, Gg^Fp, Gg^Vh, Ww, Ww
Wo, Wo, Wo, Wo, Wo, Ww, Ww, Ww, Gg^Fp, Gg^Fp, Gg^Fp, Rr, Gg, Gg, Hh, Ms, Ms, Ms, Ms, Ms, Ms^Vhh, Ms, Ms, Ms, Ms, Ms, Ms, Ms, Ms^Vhh, Hh, Gg, Gg, Gg, Gg, Gg, Gg, Gg, Gg, Gg^Fp, Gg^Fp, Gg^Fp, Gg^Fp, Gg^Ve, Gg, Gg^Fp, Rr, Gg^Fp, Hh, Hh, Hh, Hh, Hh, Gg^Vh, Gg, Gg, Gg, Gg^Fp, Gg, Rr, Gg, Gg^Fp, Gg, Gg, Gg, Gg, Gg^Fp, Gg^Fp, Gg^Fp, Gg^Fp, Gg, Gg, Ww
Wo, Wo, Wo, Wo, Wo, Ww, Ww, Ww, Gg, Gg^Ve, Gg, Rr, Gg, Gg, Gg, Hh, Ms, Ms, Ms, Ms, Ms, Ms, Ms, Ms, Ms, Ms, Ms, Ms, Ms, Hh, Hh, Gg, Gg, Gg, Gg, Gg, Gg^Fp, Gg, Gg^Fp, Gg^Fp, Gg^Fp, Gg^Fp, Gg^Fp, Gg^Fp, Gg^Fp, Rr, Hh, Hh, Hh, Hh, Hh, Hh, Hh, Gg, Gg, Gg, Rr, Rr, Gg, Gg, Gg^Ve, Gg, Gg, Gg, Gg^Fp, Gg^Fp, Gg, Gg, Gg, Gg, Gg, Ww
Wo, Ww, Ww, Ww, Ww, Ww, Ww, Gg, Gg, Gg, Gg, Rr, Gg, Gg, Gg, Gg, Hh, Hh, Ms, Ms, Ms, Ms, Ms, Ms, Ms, Ms, Ms, Ms, Ms, Ms, Hh, Gg^Fp, Gg^Fp, Gg^Fp, Gg^Fp, Gg^Fp, Gg^Fp, Gg, Gg^Fp, Gg^Fp, Gg^Ve, Gg^Fp, Gg^Fp, Gg^Fp, Gg^Fp, Rr, Rr, Hh, Hh, Hh, Hh, Hh, Gg^Fp, Gg^Fp, Rr, Rr, Gg, Gg, Gg, Gg, Gg^Fp, Gg^Fp, Gg^Fp, Gg^Fp, Gg^Fp, Gg, Gg, Gg, Gg^Vh, Gg, Gg, Ww
Wo, Ww, Ww, Ww^Vm, Gg^Fp, Gg^Fp, Gg^Fp, Gg^Fp, Gg, Gg, Gg, Rr, Gg, Gg, Gg^Vh, Gg, Gg, Gg^Fp, Hh, Ms, Ms, Ms, Ms, Ms, Ms, Ms, Ms, Ms, Ms, Ms, Hh, Gg, Gg, Gg, Gg^Fp, Gg^Fp, Gg, Gg, Gg, Gg, Gg^Fp, Gg^Fp, Gg^Fp, Gg, Gg, Gg^Fp, Gg, Rr, Hh, Hh, Gg^Fp, Gg^Fp, Gg^Fp, Gg^Fp, Gg^Fp, Gg, Gg, Gg, Gg, Gg, Gg^Fp, Gg, Gg, Gg, Gg^Fp, Gg, Gg^Fp, Gg, Gg, Gg, Gg^Fp, Ww
Wo, Ww, Ww, Ww, Gg^Fp, Gg^Fp, Gg^Fp, Gg^Fp, Gg^Fp, Gg, Gg, Rr, Rr, Gg, Gg, Gg, Gg, Gg, Gg^Fp, Hh, Ms, Ms, Ms, Ms, Ms, Ms, Ms, Ms, Ms, Ms, Hh, Hh, Gg^Vh, Gg, Gg, Gg, Gg^Fp, Gg, Gg, Gg, Gg, Gg, Gg, Gg, Gg, Gg, Gg^Vh, Rr, Rr, Hh, Rr, Rr, Gg^Fp, Gg^Fp, Gg, Gg, Gg, Gg, Gg, Gg, Gg, Gg, Gg, Gg, Gg, Gg, Gg, Gg, Gg, Gg^Fp, Ww, Ww
Wo, Ww, Ww, Ww, Ww, Ww, Gg, Gg^Fp, Gg, Gg, Gg^Fp, Gg^Fp, Rr, Gg, Gg, Gg, Gg^Fp, Gg, Gg, Hh, Hh, Ms, Ms, Ms, Ms, Ms, Ms, Ms, Ms, Hh, Hh, Hh, Gg, Gg, Gg, Gg, Gg^Fp, Gg^Fp, Gg, Gg, Gg, Gg, Gg, Gg, Gg, Gg, Gg, Gg, Gg^Vh, Rr, Gg, Gg, Gg^Fp, Gg^Fp, Gg, Gg^Vh, Gg, Gg, Gg, Gg, Gg, Gg, Gg, Gg, Gg, Gg, Gg, Gg^Fp, Gg^Fp, Gg^Fp, Ww, Ww
Wo, Wo, Ww, Ww, Ww, Ww, Gg, Gg, Gg, Gg, Gg, Gg, Rr, Gg^Fp, Gg^Fp, Gg, Gg^Fp, Gg, Gg, Gg, Gg^Vh, Hh, Ms, Ms, Ms, Ms, Ms, Ms, Ms, Hh, Hh, Gg^Fp, Gg^Fp, Gg, Gg, Gg, Gg^Fp, Gg^Fp, Gg, Gg, Gg, Gg, Gg, Gg, Gg, Gg^Fp, Gg^Fp, Gg, Gg, Gg, Gg, Gg, Gg^Fp, Gg^Fp, Gg, Gg, Gg, Gg^Fp, Gg, Gg, Gg, Gg^Fp, Gg, Gg, Gg, Gg, Gg, Gg^Fp, Ww, Ww, Ww, Ww
Wo, Wo, Wo, Ww, Ww, Ww, Ww, Gg, Ww, Ww, Ww, Ww, Rr, Ww, Ww, Gg, Gg^Fp, Gg, Gg, Gg, Gg, Hh, Hh, Hh, Ms, Ms, Ms, Ms, Hh, Hh, Gg, Gg, Gg^Fp, Gg, Gg, Gg^Fp, Gg^Fp, Gg, Gg, Gg^Fp, Gg, Gg, Gg, Gg, Gg^Fp, Gg^Fp, Gg^Fp, Gg^Fp, Gg, Gg, Gg, Gg^Fp, Gg^Fp, Gg^Fp, Gg^Fp, Gg, Gg, Gg, Gg, Gg, Gg^Fp, Gg^Fp, Gg^Fp, Gg^Vh, Gg, Gg, Gg, Gg^Fp, Ww, Ww, Ww, Ww
Wo, Wo, Wo, Ww, Ww, Ww, Ww, Ww, Ww, Ww, Ww, Ww, Ch, Ww, Ww, Gg^Vh, Gg^Fp, Gg^Fp, Gg, Gg, Gg^Fp, Gg^Fp, Hh, Hh, Hh, Ms, Ms, Ms, Hh, Hh, Gg, Gg, Gg^Fp, Gg, Gg^Fp, Gg^Fp, Gg^Fp, Gg, Gg, Gg^Fp, Gg^Fp, Gg, Gg, Gg, Gg^Fp, Gg^Fp, Gg^Fp, Gg^Fp, Gg^Fp, Gg^Fp, Gg^Fp, Gg^Fp, Gg^Fp, Gg^Fp, Gg^Fp, Gg, Gg, Gg, Gg, Gg^Fp, Gg^Fp, Gg, Gg, Gg, Gg, Ww, Ww, Ww, Ww, Ww, Ww, Ww
Wo, Wo, Wo, Ww, Ww^Vm, Ww, Ww, Ww, Ww, Ww, Ww, Ww, Ww, Rr, Gg^Fp, Ww, Ww, Gg^Fp, Gg, Gg, Gg, Gg^Fp, Gg, Hh, Hh, Hh, Hh^Vhh, Hh, Hh, Hh, Gg, Gg^Fp, Gg, Gg, Gg^Fp, Gg^Fp, Gg^Fp, Gg, Gg, Gg^Fp, Gg^Ve, Gg, Gg, Gg, Gg, Gg^Fp, Gg^Fp, Gg^Fp, Gg^Fp, Gg^Fp, Gg^Fp, Gg^Fp, Gg^Fp, Gg^Fp, Gg^Fp, Gg^Fp, Gg^Fp, Gg^Fp, Gg^Fp, Gg^Fp, Gg^Fp, Gg, Gg, Ww, Ww, Ww, Ww, Ww, Ww^Vm, Ww, Ww, Wo
Wo, Wo, Wo, Ww, Ww, Ww, Ww, Ww^Vm, Ww, Ww, Ww, Ww, Ww, Rr, Gg, Ww, Gg^Fp, Ww, Gg, Gg, Gg, Gg, Gg, Gg, Gg, Hh, Hh, Hh, Hh, Gg^Fp, Gg^Fp, Gg, Gg, Gg, Gg^Fp, Gg^Fp, Gg^Fp, Gg^Fp, Gg, Gg, Gg^Fp, Gg^Fp, Gg, Gg, Gg, Gg, Gg, Gg, Gg, Gg^Fp, Gg^Fp, Gg^Fp, Gg, Gg^Fp, Gg^Fp, Gg^Fp, Gg^Fp, Gg^Fp, Gg^Fp, Gg^Fp, Gg^Fp, Ww, Ww, Ww, Ww, Ww, Ww, Ww, Ww, Ww, Ww, Wo
Wo, Wo, Wo, Ww, Ww, Ww, Ww, Ww, Ww, Ww, Gg, Gg, Rr, Rr, Gg, Gg, Gg^Fp, Ww, Ww, Gg, Gg, Gg, Gg, Gg, Gg, Gg^Fp, Gg, Gg, Gg, Gg, Gg, Gg^Fp, Gg, Gg, Gg^Fp, Gg^Fp, Gg^Fp, Gg^Fp, Gg, Gg, Gg, Gg^Fp, Gg, Gg, Gg, Gg, Gg, Gg, Gg^Vh, Gg, Gg, Gg, Gg, Gg, Gg^Vh, Gg^Fp, Gg^Fp, Gg^Fp, Gg^Fp, Gg^Fp, Gg^Fp, Ww, Ww, Ww, Ww, Ww, Ww, Ww, Ww, Wo, Wo, Wo
Wo, Wo, Ww, Ww, Ww, Ww, Ww, Ww, Ww, Gg, Rr, Rr, Gg^Fp, Gg, Gg, Gg, Gg, Gg, Ww, Gg^Vh, Gg, Gg, Gg, Gg, Gg^Vh, Gg, Gg, Gg, Gg, Gg, Gg, Gg^Fp, Gg^Fp, Gg, Gg, Gg^Fp, Gg^Fp, Gg^Fp, Gg, Gg, Gg, Gg, Gg, Gg, Gg, Gg, Gg^Fp, Gg^Fp, Gg, Gg, Gg, Gg, Gg, Gg, Gg, Gg, Gg^Fp, Gg, Gg, Gg^Fp, Gg^Fp, Ww, Ww, Ww, Ww, Ww, Ww, Ww^Vm, Wo, Wo, Wo, Wo
Ww, Ww, Ww, Ww^Vm, Ww, Ww, Ww, Ww, Gg^Vh, Gg, Rr, Gg, Gg, Gg, Gg, Gg, Gg^Fp, Gg^Fp, Gg, Ww, Ww, Gg, Gg, Gg, Gg, Gg, Gg, Gg, Gg, Gg, Gg^Fp, Gg^Fp, Gg^Ve, Gg, Gg, Gg^Fp, Gg^Fp, Gg^Fp, Gg^Fp, Gg, Gg, Gg, Gg, Gg, Gg, Gg, Gg^Fp, Gg^Ve, Gg, Gg, Gg, Gg, Gg, Gg, Gg, Gg, Gg, Gg, Gg, Gg, Gg^Fp, Ww, Ww, Ww, Wo, Wo, Wo, Wo, Wo, Wo, Wo, Wo
Ww, Ww, Ww, Ww, Ww, Ww, Ww, Gg, Gg, Gg, Rr, Gg, Gg, Gg, Gg, Gg^Fp, Gg^Fp, Gg^Fp, Ww, Ww, Ww, Ww, Gg, Gg, Gg, Gg, Gg, Gg, Gg, Gg^Fp, Gg^Fp, Gg^Fp, Gg^Fp, Gg, Gg, Gg, Gg^Fp, Gg^Fp, Gg^Fp, Gg^Fp, Gg, Gg^Vh, Gg, Gg, Gg, Gg, Gg, Gg^Fp, Gg^Fp, Gg, Gg, Gg, Gg, Gg, Gg, Gg, Gg, Gg, Gg, Gg, Ww, Ww, Ww, Ww, Wo, Wo, Wo, Wo, Wo, Wo, Wo, Wo
Ww, Ww, Ww, Ww, Ww, Gg, Gg, Gg, Gg, Gg, Rr, Gg, Gg, Gg, Gg, Gg^Fp, Gg^Fp, Gg^Fp, Ww, Ww, Ww, Ww, Ww, Hh, Gg, Gg, Gg, Gg, Gg^Fp, Gg^Fp, Gg^Fp, Gg^Fp, Gg, Gg, Gg, Gg^Fp, Gg^Fp, Gg^Fp, Gg^Fp, Gg^Fp, Gg, Gg, Gg, Gg, Gg, Gg, Gg, Gg, Gg, Gg^Fp, Gg, Gg, Gg, Gg, Gg, Gg, Gg, Gg, Gg, Gg, Gg^Vh, Ww, Ww, Ww, Ww, Ww, Ww, Wo, Wo, Wo, Wo, Wo
Ww, Ww, Ww, Ww, Gg, Gg, Gg, Gg, Gg, Gg, Rr, Gg, Gg, Gg, Gg, Gg^Fp, Gg^Fp, Gg^Vh, Ww, Ww, Ww, Ww, Ww, Ww, Hh, Gg, Gg, Gg, Gg^Fp, Gg^Fp, Gg, Gg, Gg, Gg, Gg^Fp, Gg^Fp, Gg^Fp, Gg^Fp, Gg^Fp, Gg^Fp, Gg^Fp, Gg, Gg, Gg, Gg, Gg, Gg, Gg, Gg, Gg, Gg, Gg, Gg, Gg^Fp, Gg^Fp, Gg^Fp, Gg^Fp, Gg^Fp, Gg, Gg, Gg, Ww, Ww, Ww, Ww, Ww, Ww, Ww, Wo, Wo, Wo, Wo
Ww, Ww, Ww, Gg, Gg, Gg, Gg, Gg, Gg, Gg, Rr, Gg, Gg, Gg, Gg, Gg, Gg^Fp, Gg^Fp, Gg^Ve, Ww, Ww, Ww, Ww, Hh, Hh, Gg, Gg, Gg, Gg, Gg, Gg, Gg, Gg^Vh, Gg, Gg, Gg, Gg, Gg, Gg, Gg, Gg, Gg, Gg, Gg, Gg, Gg, Gg, Gg, Gg, Gg, Gg, Gg, Gg, Gg^Fp, Gg^Fp, Gg^Fp, Gg^Fp, Gg^Fp, Gg^Fp, Gg, Gg^Vh, Gg, Ww, Ww, Ww, Ww, Ww, Ww, Ww, Wo, Wo, Wo
Ww, Ww, Gg, Gg, Gg, Gg, Gg, Gg, Rr, Rr, Gg, Gg, Gg, Hh, Gg, Gg, Gg, Gg, Gg^Fp, Hh, Ww, Hh, Hh, Hh, Hh, Gg, Gg^Fp, Gg, Gg, Gg, Gg, Gg, Gg, Gg, Gg, Gg, Gg, Gg, Gg, Gg, Gg, Gg, Gg, Gg, Gg^Fp, Gg^Fp, Gg^Fp, Gg^Fp, Gg^Fp, Gg, Gg, Gg, Gg, Gg, Gg, Gg, Gg^Fp, Gg^Fp, Gg^Fp, Gg, Gg, Gg, Gg, Gg, Gg, Gg^Fp, Ww, Ww^Vm, Ww, Wo, Wo, Wo
Ww, Ww, Gg, Gg, Gg, Gg, Gg, Gg, Rr, Gg^Vh, Gg, Gg, Gg, Hh, Gg, Gg, Gg, Gg, Gg, Hh, Hh, Hh, Hh, Gg, Gg, Gg, Gg^Fp, Gg^Fp, Gg^Fp, Gg, Gg, Gg, Gg, Gg, Gg, Gg, Gg, Gg, Gg, Gg, Gg, Gg, Gg, Gg, Gg^Fp, Gg^Ve, Gg^Fp, Gg^Fp, Gg, Gg, Gg, Gg, Gg, Gg, Gg, Gg, Gg, Gg^Fp, Gg^Fp, Gg^Fp, Gg^Fp, Gg^Fp, Gg^Fp, Gg^Fp, Gg^Fp, Gg^Fp, Gg^Fp, Ww, Ww, Ww, Ww, Wo
Ww, Gg, Gg^Vh, Gg, Gg, Gg^Fp, Gg^Fp, Gg^Fp, Gg^Fp, Gg^Fp, Gg, Gg, Gg, Gg, Hh, Hh, Hh, Gg, Gg, Gg, Gg^Fp, Gg, Gg, Gg^Fp, Gg, Gg, Gg^Fp, Gg^Fp, Gg^Fp, Gg^Fp, Gg^Vh, Gg, Gg, Gg, Hh, Hh, Gg, Gg, Gg^Fp, Gg^Fp, Gg, Gg, Gg, Gg, Gg, Gg^Fp, Gg^Fp, Gg^Fp, Gg, Gg, Gg, Gg, Gg, Gg^Fp, Gg^Fp, Gg, Gg, Gg, Gg^Fp, Gg^Fp, Gg^Fp, Gg, Gg, Gg, Gg, Gg, Gg^Fp, Gg^Fp, Ww, Ww, Ww, Wo
Ww, Gg, Gg, Gg, Gg, Gg^Fp, Gg^Fp, Gg^Fp, Gg^Fp, Gg^Fp, Gg, Gg, Gg, Gg, Hh, Hh, Gg, Gg, Gg, Gg, Gg, Gg^Fp, Gg^Fp, Gg, Gg^Fp, Gg, Gg^Fp, Gg, Gg, Gg^Fp, Gg, Gg, Gg^Vh, Hh, Hh, Hh, Hh, Gg, Gg^Fp, Gg^Fp, Gg^Fp, Gg^Fp, Gg, Gg, Gg, Gg, Gg, Gg, Gg, Gg, Gg, Gg, Gg^Fp, Gg^Ve, Gg^Fp, Gg^Fp, Gg, Gg, Gg, Gg^Fp, Gg^Fp, Gg, Gg^Vh, Gg, Gg, Gg, Ww, Ww, Ww, Ww, Ww, Ww
Ww, Gg, Gg, Gg, Gg, Gg, Gg^Fp, Gg, Gg, Gg, Gg, Gg, Hh, Hh, Gg^Fp, Gg^Fp, Gg, Gg, Gg, Gg, Gg, Gg, Gg, Gg, Gg, Gg, Gg, Gg^Fp, Gg^Fp, Gg^Fp, Gg^Fp, Hh, Hh, Hh, Ms, Hh, Hh, Hh, Gg^Fp, Gg^Ve, Gg^Fp, Gg^Fp, Gg^Fp, Gg^Fp, Gg, Gg, Gg, Gg, Gg, Gg, Gg, Gg, Gg^Fp, Gg^Fp, Gg, Gg^Ve, Gg^Fp, Gg, Gg, Gg^Fp, Gg^Fp, Gg, Gg, Gg, Gg, Gg, Ww, Ww, Ww, Ww, Ww, Ww
Ww, Gg, Gg, Gg, Gg, Gg, Gg, Gg, Gg, Gg, Gg, Gg^Fp, Gg^Fp, Hh, Gg^Vh, Gg, Gg^Fp, Gg, Gg, Gg, Gg, Gg, Gg^Vh, Gg, Gg, Gg, Gg^Fp, Gg^Fp, Gg^Fp, Gg^Fp, Gg^Fp, Gg, Hh, Hh, Ms, Ms, Hh, Hh, Gg^Fp, Gg^Fp, Gg^Fp, Gg, Gg, Gg^Fp, Gg, Gg^Fp, Gg^Fp, Gg^Fp, Gg^Fp, Gg^Fp, Gg^Fp, Gg, Gg, Gg^Fp, Gg^Fp, Gg^Fp, Gg^Fp, Gg, Gg, Gg^Fp, Gg^Fp, Gg, Gg, Gg, Gg, Gg, Ww, Ww, Ww, Ww, Ww, Ww
Ww^Fp, Ww^Fp, Gg, Gg, Gg, Gg, Gg, Gg, Gg, Gg, Gg^Fp, Gg^Fp, Gg, Gg, Hh, Hh, Gg^Fp, Gg, Gg, Gg, Gg^Fp, Gg, Gg^Fp, Gg^Fp, Gg, Gg, Gg^Fp, Gg^Fp, Gg^Fp, Gg^Fp, Gg^Fp, Hh, Hh, Ms, Ms, Ms, Hh, Hh, Gg^Fp, Gg^Fp, Gg^Fp, Gg, Gg^Fp, Gg^Fp, Gg^Vh, Gg, Gg^Fp, Gg^Fp, Gg^Fp, Gg^Fp, Gg^Fp, Gg^Fp, Gg, Gg, Gg^Fp, Gg, Rr, Rr, Rr, Rr, Gg^Fp, Rr, Rr, Gg, Ch, Ch, Ch, Ww, Ww, Ww, Ww, Ww
Ww, Ww, Gg^Fp, Gg^Fp, Gg^Ve, Gg^Fp, Gg, Gg, Gg^Fp, Gg^Ve, Gg^Fp, Gg^Fp, Gg, Gg, Hh, Gg, Gg^Fp, Gg, Gg, Gg^Fp, Gg^Fp, Gg^Fp, Gg^Fp, Gg^Fp, Gg^Fp, Gg^Fp, Gg^Fp, Gg^Fp, Gg^Fp, Gg^Fp, Gg, Hh, Ms, Hh, Ms, Hh, Hh, Gg^Fp, Gg, Gg^Fp, Gg^Ve, Gg^Fp, Gg^Fp, Gg^Fp, Gg, Gg, Gg, Gg^Fp, Gg^Fp, Gg^Fp, Gg^Fp, Gg^Fp, Gg, Gg, Gg, Gg, Rr, Gg, Gg, Gg, Gg^Fp, Gg^Fp, Gg^Vh, Rr, Ch, 6 Kh, Ch, Ww, Ww, Ww, Ww, Ww
Ww, Ww, Ww, Ww, Gg^Fp, Gg^Fp, Gg^Fp, Gg, Gg^Fp, Gg^Fp, Gg, Gg, Gg, Gg, Gg, Gg^Fp, Gg^Fp, Gg, Gg, Gg^Fp, Gg^Fp, Gg^Fp, Gg^Fp, Gg^Fp, Gg^Fp, Gg^Fp, Gg^Fp, Gg^Fp, Gg^Fp, Gg, Gg, Hh, Hh, Hh, Hh, Hh, Gg^Fp, Gg, Gg^Fp, Gg^Fp, Gg^Fp, Gg^Fp, Gg^Fp, Gg, Gg, Gg, Gg, Gg, Gg, Gg, Gg, Gg, Gg, Gg, Rr, Rr, Gg, Gg, Gg, Gg, Gg^Fp, Gg^Fp, Gg, Gg, Gg, Ch, Gg^Vh, Ww, Ww, Ww, Ww, Ww
Ww, Ww, Ww, Ww, Ww, Ww, Ww, Gg, Gg, Gg, Gg^Fp, Gg, Gg, Gg^Fp, Gg^Fp, Gg^Fp, Gg^Fp, Gg, Gg, Gg, Gg, Gg, Gg, Gg^Fp, Gg, Gg^Fp, Gg^Fp, Gg^Fp, Gg^Fp, Gg^Vh, Gg, Gg^Fp, Hh, Hh, Gg, Gg, Gg, Gg, Gg, Gg, Gg, Gg, Gg, Gg, Gg, Gg, Gg, Gg, Gg, Gg^Fp, Gg, Gg, Rr, Rr, Gg, Gg, Gg, Gg^Fp, Gg^Fp, Gg^Fp, Gg^Fp, Gg^Fp, Gg^Fp, Gg^Fp, Gg^Fp, Gg^Fp, Gg, Ww, Ww, Ww, Ww, Ww
Ww, Ww, Ww, Ww, Ww, Ww, Ww, Ww, Gg, Gg, Gg, Gg^Fp, Gg^Fp, Gg^Ve, Gg^Fp, Gg, Gg, Gg, Gg^Vh, Gg, Gg, Gg, Gg, Gg, Gg, Gg, Gg^Fp, Gg^Fp, Gg^Fp, Gg, Gg, Gg^Fp, Gg^Fp, Gg^Fp, Gg^Fp, Gg, Gg, Gg, Gg, Gg, Gg, Gg, Gg, Gg, Gg, Gg, Gg, Gg, Gg, Gg, Gg, Rr, Gg^Vh, Gg, Gg, Gg, Gg^Fp, Gg^Fp, Gg^Fp, Gg^Fp, Gg^Fp, Gg^Fp, Gg^Fp, Gg^Fp, Gg^Fp, Gg^Fp, Gg, Ww, Ww, Ww, Ww, Ww
Ww, Wo, Wo, Wo, Wo, Wo, Wo, Ww, Ww, Ww, Gg, Gg, Gg, Gg^Fp, Gg, Gg, Gg, Gg, Gg, Gg, Gg, Gg, Gg, Gg, Gg, Gg, Gg^Fp, Gg^Fp, Gg, Gg, Gg, Gg^Fp, Gg^Ve, Gg^Fp, Gg^Fp, Gg, Gg, Gg, Gg, Gg, Gg, Gg, Gg, Gg, Gg, Gg, Gg, Gg, Gg, Gg, Gg, Rr, Gg, Gg, Gg, Gg, Gg^Fp, Gg^Fp, Gg^Fp, Gg^Fp, Gg^Fp, Gg^Fp, Gg^Fp, Gg^Fp, Gg^Fp, Gg, Ww, Ww, Ww, Ww, Ww, Ww
Ww, Wo, Wo, Wo, Wo, Wo, Wo, Wo, Wo, Ww, Ww, Gg, Gg, Gg, Gg, Gg, Gg, Gg, Gg, Gg, Gg, Gg, Gg, Gg, Gg^Vh, Gg, Gg^Fp, Gg^Fp, Gg^Fp, Gg, Gg, Gg^Fp, Gg^Fp, Gg^Fp, Gg^Fp, Gg^Fp, Gg, Gg, Gg, Gg, Gg, Gg, Gg, Gg, Gg, Gg, Rr, Gg^Vh, Rr, Gg^Vh, Rr, Rr, Gg, Gg, Gg, Gg, Gg^Fp, Gg^Fp, Gg^Fp, Gg^Fp, Gg^Fp, Gg^Fp, Gg^Fp, Gg^Fp, Gg^Fp, Gg, Ww, Ww, Ww, Ww, Ww, Ww
Wo, Wo, Wo, Wo, Wo, Wo, Wo, Wo, Wo, Wo, Ww, Ww, Gg, Gg, Gg, Gg, Gg, Gg, Gg, Gg, Gg, Gg, Gg, Gg, Gg, Gg, Gg^Fp, Gg^Fp, Gg^Fp, Gg, Gg, Gg^Fp, Gg^Fp, Gg^Fp, Gg^Fp, Gg, Gg, Gg, Gg^Fp, Gg, Gg, Gg, Gg, Gg, Rr, Rr, Gg^Fp, Rr, Gg, Rr, Gg, Gg, Gg, Gg, Gg, Gg, Gg, Gg, Gg, Gg, Gg, Gg, Gg^Fp, Gg, Gg, Gg, Gg, Ww, Ww, Ww, Ww, Ww
Wo, Wo, Wo, Wo, Wo, Wo, Wo, Wo, Wo, Wo, Ww, Ww, Ww, Gg, Gg, Gg, Gg, Gg, Gg, Gg, Gg, Gg, Gg, Gg, Gg, Gg^Fp, Gg^Fp, Gg^Fp, Gg^Fp, Gg, Gg, Gg, Gg, Gg, Gg, Gg, Gg, Gg, Gg, Gg, Gg, Gg, Gg, Rr, Gg^Fp, Gg^Fp, Gg^Fp, Gg^Fp, Gg^Fp, Gg^Fp, Gg^Fp, Gg, Gg, Gg, Gg^Fp, Gg^Fp, Gg, Gg^Fp, Gg^Ve, Gg, Gg, Gg^Vh, Gg^Fds, Gg^Fds, Gg^Fds, Gg, Gg, Gg, Gg, Ww, Ww, Wo
Wo, Wo, Wo, Wo, Wo, Wo, Wo, Wo, Wo, Wo, Wo, Ww, Ww^Vm, Ww, Gg^Vh, Gg, Gg, Gg, Gg, Gg, Gg, Gg, Gg, Gg, Gg^Fp, Gg^Fp, Gg^Fp, Gg^Fp, Gg^Fp, Gg, Gg, Gg, Gg, Gg, Gg, Gg, Gg, Gg, Gg, Gg, Gg, Gg, Gg, Rr, Gg^Fp, Gg^Fp, Gg^Fp, Gg^Fp, Gg^Fp, Gg^Fp, Gg^Fp, Gg^Fp, Gg, Gg, Gg^Fp, Gg^Fp, Gg^Fp, Gg^Fp, Gg^Fp, Gg, Gg, Gg, Gg^Fds, Gg^Fds, Gg^Fds, Gg^Fds, Gg, Gg, Ww, Ww, Ww, Wo
Wo, Wo, Wo, Wo, Wo, Wo, Wo, Wo, Wo, Wo, Wo, Wo, Ww, Ww, Ww, Gg^Fp, Gg, Gg, Gg, Gg, Gg, Gg, Gg, Gg, Gg, Gg^Fp, Gg^Fp, Gg^Fp, Gg^Fp, Gg^Fp, Gg^Fp, Gg^Fp, Gg, Gg, Gg, Gg, Gg, Gg, Gg^Vh, Gg, Gg, Gg, Rr, Rr, Gg, Gg, Gg, Gg, Gg, Gg, Gg^Fp, Gg^Fp, Gg, Gg, Gg^Fp, Gg, Gg, Gg, Gg^Fds, Gg, Gg, Gg, Gg, Gg^Fds, Gg^Fds, Gg^Fds, Ww, Ww, Ww, Wo, Wo, Wo
Wo, Wo, Wo, Wo, Wo, Wo, Wo, Wo, Wo, Wo, Wo, Wo, Wo, Ww, Ww, Ww, Gg, Gg^Fp, Gg^Fp, Gg, Gg, Gg, Gg, Gg, Gg, Gg, Gg^Fp, Gg^Fp, Gg^Fp, Gg^Fp, Gg^Fp, Gg^Fp, Gg^Fp, Gg, Gg, Gg, Gg, Gg, Rr, Rr, Rr, Rr, Gg, Gg^Fp, Gg^Fp, Gg, Gg, Gg, Gg, Gg, Gg, Gg, Gg, Gg, Gg^Fp, Gg, Gg, Gg, Gg^Fds, Gg, Gg, Gg, Ww, Ww, Ww, Ww, Ww, Ww, Wo, Wo, Wo, Wo
Wo, Wo, Wo, Wo, Wo, Wo, Wo, Wo, Wo, Wo, Wo, Wo, Wo, Ww, Ww, Ww, Ww, Gg^Fp, Gg^Fp, Gg^Ve, Gg^Fp, Gg^Fp, Gg, Gg, Gg, Gg^Fp, Gg^Fp, Gg^Fp, Gg^Fp, Gg^Fp, Gg^Fp, Gg^Fp, Gg^Fp, Gg, Gg, Gg, Rr, Rr, Gg, Gg^Fp, Gg^Fp, Gg^Fp, Gg, Gg^Fp, Ww, Gg^Fp, Gg^Fp, Gg^Fp, Gg^Fp, Gg, Gg, Gg, Gg, Gg, Gg, Gg^Fp, Gg, Gg, Gg^Fds, Gg, Gg^Ve, Ww^Bw\, Ww^Bw\, Ww, Ww, Wo, Wo, Wo, Wo, Wo, Wo, Wo
Wo, Wo, Wo, Wo, Wo, Wo, Wo, Wo, Wo, Wo, Wo, Wo, Wo, Wo, Ww, Ww^Vm, Ww, Gg, Gg^Fp, Gg^Fp, Gg, Gg^Fp, Gg^Fp, Gg, Gg^Fp, Gg, Gg^Vh, Gg, Gg, Gg, Gg, Gg^Fp, Gg, Gg, Rr, Rr, Gg, Gg, Gg, Gg^Fp, Gg^Fp, Gg^Fp, Gg^Fp, Gg^Fp, Gg^Fp, Gg^Fp, Gg^Fp, Gg^Ve, Gg^Fp, Gg^Fp, Gg^Fp, Gg, Gg, Gg, Gg, Gg, Gg^Fp, Gg, Gg, Gg, Ww, Ww, Ww, Wo^Bw\, Wo^Bw\, Wo, Wo, Wo, Wo, Wo, Wo, Wo
Wo, Wo, Wo, Wo, Wo, Wo, Wo, Wo, Wo, Wo, Wo, Wo, Wo, Wo, Wo, Ww, Ww, Ww, Gg^Fp, Ww, Gg, Gg, Gg^Fp, Gg, Gg^Fp, Gg, Gg, Gg^Fp, Gg^Fp, Gg, Gg, Gg, Gg, Gg, Rr, Gg^Ve, Gg^Fp, Gg, Gg, Gg^Fp, Ww, Ww, Ww, Ww, Ww, Ww, Gg^Fp, Gg^Fp, Gg^Fp, Gg^Fp, Gg^Fp, Ch, 5 Ch, Ch, Gg, Gg, Gg, Gg, Ww^Bw\, Ww, Ww, Ww^Vm, Wo, Wo, Wo, Wo, Wo, Wo, Wo, Wo, Wo, Wo
Wo, Wo, Wo, Wo, Wo, Wo, Wo, Wo, Wo, Wo, Wo, Wo, Wo, Wo, Wo, Wo, Ww, Ww, Ww, Gg, Gg^Vh, Ww, Gg^Fp, Gg, Gg^Fp, Gg, Gg^Fp, Ww, Ww, Gg^Fp, Gg, Ch, Ch, Ch, Rr, Gg^Fp, Gg^Fp, Gg, Gg^Fp, Ww, Ww, Ww, Ww, Ww, Ww, Ww, Ww, Gg^Fp, Gg^Fp, Gg^Fp, Gg^Ve, Ch, Kh, Ch, Gg, Gg, Gg, Gg, Gg, Wo^Bw\, Wo^Bw\, Wo, Wo, Wo, Wo, Wo, Wo, Wo, Wo, Wo, Wo, Wo
Wo, Wo, Wo, Wo, Wo, Wo, Wo, Wo, Wo, Wo, Wo, Wo, Wo, Wo, Wo, Wo, Ww, Ww, Ww, Gg, Gg, Ww, Gg^Fp, Gg, Gg, Gg, Ww, Ww, Gg, Ww, Gg^Fp, Ch, 4 Kh, Ch, Gg, Gg^Vh, Gg^Fp, Gg^Fp, Ww, Ww, Ww, Ww, Ww^Vm, Ww, Ww, Ww, Ww, Ww, Ww, Gg^Fp, Gg^Fp, Gg^Fp, Ch, Gg, Gg, Gg, Gg, Gg, Ww^Bw\, Wo, Wo, Wo, Wo, Wo, Wo, Wo, Wo, Wo, Wo, Wo, Wo, Wo
Wo, Wo, Wo, Wo, Wo, Wo, Wo, Wo, Wo, Wo, Wo, Wo, Wo, Wo, Wo, Ww, Ww, Ww, Ww, Ww, Ww, Ww, Ww, Gg, Gg, Gg^Fp, Ww, Gg, Gg, Ww, Gg^Fp, Gg, Ch, Gg, Gg, Gg, Gg, Ww, Ww, Ww, Ww, Ww, Ww, Ww, Ww, Ww, Ww^Vm, Ww, Ww, Ww, Ww, Gg, Gg, Gg, Gg, Gg, Gg, Gg, Wo, Wo^Bw\, Wo^Bw\, Wo, Wo, Wo, Wo, Wo, Wo, Wo, Wo, Wo, Wo, Wo
Wo, Wo, Wo, Wo, Wo, Wo, Wo, Wo, Wo, Wo, Wo, Wo, Wo, Wo, Wo, Wo, Ww, Ww, Ww, Ww, Ww, Ww, Ww, Ww, Ww, Ww, Gg^Fp, Ww, Ww, Gg^Fp, Gg^Fp, Gg, Gg, Gg, Gg, Gg, Ww, Ww, Ww, Ww, Ww, Ww, Ww, Wo, Wo, Ww, Ww, Ww, Ww^Vm, Ww, Ww, Gg, Ww, Gg, Ww, Gg, Ww^Vm, Wo^Bw\, Wo^Bw\, Wo, Wo, Wo, Wo, Wo, Wo, Wo, Wo, Wo, Wo, Wo, Wo, Wo
Wo, Wo, Wo, Wo, Wo, Wo, Wo, Wo, Wo, Wo, Wo, Wo, Wo, Wo, Wo, Wo, Wo, Ww, Ww, Ww, Ww, Ww, Ww, Ww, Ww, Ww, Ww, Ww, Ww, Gg^Fp, Gg, Gg, Ww, Gg, Gg, Ww, Ww, Ww, Ww, Ww, Ww, Ww, Wo, Wo, Wo, Wo, Ww, Ww, Ww, Ww, Ww, Ww, Ww, Ww, Ww, Ww, Ww, Ww, Wo, Wo^Bw\, Wo, Wo, Wo, Wo, Wo, Wo, Wo, Wo, Wo, Wo, Wo, Wo
Wo, Wo, Wo, Wo, Wo, Wo, Wo, Wo, Wo, Wo, Wo, Wo, Wo, Wo, Wo, Wo, Wo, Ww, Ww, Ww, Ww, Ww, Ww, Ww, Ww, Ww, Ww, Ww, Ww, Ww, Ww, Ww, Ww, Ww, Ww, Ww, Ww, Ww^Vm, Ww, Wo, Wo, Wo, Wo, Wo, Wo, Wo, Wo, Ww, Ww, Ww, Ww, Ww, Ww, Ww, Ww, Ww, Ww, Ww, Wo, Wo, Wo, Wo, Wo, Wo, Wo, Wo, Wo, Wo, Wo, Wo, Wo, Wo
Wo, Wo, Wo, Wo, Wo, Wo, Wo, Wo, Wo, Wo, Wo, Wo, Wo, Wo, Wo, Wo, Wo, Wo, Wo, Ww, Ww, Ww, Ww, Ww, Ww, Ww, Ww, Ww, Ww, Ww, Ww, Ww, Ww, Ww, Ww, Ww, Ww, Ww, Wo, Wo, Wo, Wo, Wo, Wo, Wo, Wo, Wo, Wo, Ww, Ww, Ww, Ww, Ww, Ww, Ww, Ww, Ww, Wo, Wo, Wo, Wo, Wo, Wo, Wo, Wo, Wo, Wo, Wo, Wo, Wo, Wo, Wo
