Wo, Wo, Wo, Wo, Wo, Wo, Wo, Wo, Wo, Wo, Wo, Wo, Wo, Wo, Wo, Wo, Wo, Wo, Wo, Wo, Wo, Wo, Wo, Wo, Wo, Wo, Wo, Wo, Wo, Wo, Wo, Wo, Wo, Wo, Wo, Wo, Wo, Wo, Wo, Wo, Wo, Wo, Wo, Wo, Wo, Wo, Wo, Wo, Wo, Wo, Wo, Wo, Wo, Wo, Wo, Wo, Wo, Wo, Wo, Wo, Wo, Wo
Wo, Wo, Wo, Wo, Wo, Wo, Wo, Wo, Wo, Wo, Wo, Wo, Wo, Wo, Wo, Wo, Wo, Wo, Wo, Wo, Wo, Wo, Wo, Wo, Wo, Wo, Wo, Wo, Wo, Wo, Wo, Wo, Wo, Wo, Wo, Wo, Wo, Wo, Wo, Wo, Wo, Wo, Wo, Wo, Wo, Wo, Wo, Wo, Wo, Wo, Wo, Wo, Wo, Wo, Wo, Wo, Wo, Wo, Wo, Wo, Wo, Wo
Wo, Wo, Wo, Wo, Wo, Wo, Wo, Wo, Wo, Wo, Wo, Wo, Wo, Wo, Wo, Wo, Wo, Wo, Wo, Wo, Wo, Wo, Wo, Wo, Wo, Wo, Wo, Wo, Wo, Wo, Wo, Wo, Wo, Wo, Wo, Wo, Wo, Wo, Wo, Wo, Wo, Wo, Wo, Wo, Wo, Wo, Wo, Wo, Wo, Wo, Wo, Wo, Wo, Wo, Wo, Wo, Wo, Wo, Wo, Wo, Wo, Wo
Wo, Wo, Wo, Wo, Wo, Wo, Wo, Wo, Wo, Wo, Wo, Wo, Wo, Wo, Wo, Wo, Wo, Wo, Wo, Wo, Wo, Wo, Wo, Wo, Wo, Wo, Wo, Wo, Wo, Wo, Wo, Wo, Wo, Wo, Wo, Wo, Wo, Wo, Wo, Wo, Wo, Wo, Wo, Wo, Wo, Wo, Wo, Wo, Wo, Wo, Wo, Wo, Wo, Wo, Wo, Wo, Wo, Wo, Wo, Wo, Wo, Wo
Wo, Wo, Wo, Wo, Wo, Wo, Wo, Wo, Wo, Wo, Wo, Wo, Wo, Wo, Wo, Wo, Wo, Wo, Wo, Wo, Wo, Wo, Wo, Wo, Wo, Wo, Wo, Wo, Wo, Wo, Wo, Wo, Wo, Wo, Wo, Wo, Wo, Wo, Wo, Wo, Wo, Wo, Wo, Wo, Wo, Wo, Wo, Wo, Wo, Wo, Wo, Wo, Wo, Wo, Wo, Wo, Wo, Wo, Wo, Wo, Wo, Wo
Wo, Wo, Wo, Wo, Wo, Wo, Wo, Wo, Wo, Wo, Wo, Wo, Wo, Wo, Wo, Wo, Wo, Wo, Wo, Wo, Wo, Wo, Wo, Wo, Wo, Wo, Wo, Wo, Wo, Wo, Wo, Wo, Wo, Wo, Wo, Wo, Wo, Wo, Wo, Wo, Wo, Wo, Wo, Wo, Wo, Wo, Wo, Wo, Wo, Wo, Wo, Wo, Wo, Wo, Wo, Wo, Wo, Wo, Wo, Wo, Wo, Wo
Wo, Wo, Wo, Wo, Wo, Wo, Wo, Wo, Wo, Wo, Wo, Wo, Wo, Wo, Wo, Wo, Wo, Wo, Wo, Wo, Wo, Wo, Wo, Wo, Wo, Wo, Wo, Wo, Wo, Wo, Wo, Wo, Wo, Wo, Wo, Wo, Wo, Wo, Wo, Wo, Wo, Wo, Wo, Wo, Wo, Wo, Wo, Wo, Wo, Wo, Wo, Wo, Wo, Wo, Wo, Wo, Wo, Wo, Wo, Wo, Wo, Wo
Wo, Wo, Wo, Wo, Wo, Wo, Wo, Wo, Wo, Wo, Wo, Wo, Wo, Wo, Wo, Wo, Wo, Wo, Wo, Wo, Wo, Wo, Wo, Wo, Wo, Wo, Wo, Wo, Wo, Wo, Wo, Wo, Wo, Wo, Wo, Wo, Wo, Wo, Wo, Wo, Wo, Wo, Wo, Wo, Wo, Wo, Wo, Wo, Wo, Wo, Wo, Wo, Wo, Wo, Wo, Wo, Wo, Wo, Wo, Wo, Wo, Wo
Wo, Wo, Wo, Wo, Wo, Wo, Wo, Wo, Wo, Wo, Wo, Wo, Wo, Wo, Wo, Wo, Wo, Wo, Wo, Wo, Wo, Wo, Wo, Wo, Wo, Wo, Wo, Wo, Wo, Wo, Wo, Wo, Wo, Wo, Wo, Wo, Wo, Wo, Wo, Wo, Wo, Wo, Wo, Wo, Wo, Wo, Wo, Wo, Wo, Wo, Wo, Wo, Wo, Wo, Wo, Wo, Wo, Wo, Wo, Wo, Wo, Wo
Wo, Wo, Wo, Wo, Wo, Wo, Wo, Wo, Wo, Wo, Wo, Wo, Wo, Wo, Wo, Wo, Wo, Wo, Wo, Wo, Wo, Wo, Wo, Wo, Wo, Wo, Wo, Wo, Wo, Wo, Wo, Wo, Wo, Wo, Wo, Wo, Wo, Wo, Wo, Wo, Wo, Wo, Wo, Wo, Wo, Wo, Wo, Wo, Wo, Wo, Wo, Wo, Wo, Wo, Wo, Wo, Wo, Wo, Wo, Wo, Wo, Wo
Wo, Wo, Wo, Wo, Wo, Wo, Wo, Wo, Wo, Wo, Wo, Wo, Wo, Wo, Wo, Wo, Wo, Wo, Wo, Wo, Wo, Wo, Wo, Wo, Wo, Wo, Wo, Wo, Wo, Wo, Wo, Wo, Wo, Wo, Wo, Wo, Wo, Wo, Wo, Wo, Wo, Wo, Wo, Wo, Wo, Wo, Wo, Wo, Wo, Wo, Wo, Wo, Wo, Wo, Wo, Wo, Wo, Wo, Wo, Wo, Wo, Wo
Wo, Wo, Wo, Wo, Wo, Wo, Wo, Wo, Wo, Wo, Wo, Wo, Wo, Wo, Wo, Wo, Wo, Wo, Wo, Wo, Wo, Wo, Wo, Wo, Wo, Wo, Wo, Wo, Wo, Wo, Wo, Wo, Wo, Wo, Wo, Wo, Wo, Wo, Wo, Wo, Wo, Wo, Wo, Wo, Wo, Wo, Wo, Wo, Wo, Wo, Wo, Wo, Wo, Wo, Wo, Wo, Wo, Wo, Wo, Wo, Wo, Wo
Wo, Wo, Wo, Wo, Wo, Wo, Wo, Wo, Wo, Wo, Wo, Wo, Wo, Wo, Wo, Wo, Wo, Wo, Wo, Wo, Wo, Wo, Wo, Wo, Wo, Wo, Wo, Wo, Wo, Wo, Wo, Wo, Wo, Wo, Wo, Wo, Wo, Wo, Wo, Wo, Wo, Wo, Wo, Wo, Wo, Wo, Wo, Wo, Wo, Wo, Wo, Wo, Wo, Wo, Wo, Wo, Wo, Wo, Wo, Wo, Wo, Wo
Wo, Wo, Wo, Wo, Wo, Wo, Wo, Wo, Wo, Wo, Wo, Wo, Wo, Wo, Wo, Wo, Wo, Wo, Wo, Wo, Wo, Wo, Wo, Wo, Wo, Wo, Wo, Wo, Wo, Wo, Wo, Wo, Wo, Wo, Wo, Wo, Wo, Wo, Wo, Wo, Wo, Wo, Wo, Wo, Wo, Wo, Wo, Wo, Wo, Wo, Wo, Wo, Wo, Wo, Wo, Wo, Wo, Wo, Wo, Wo, Wo, Wo
Wo, Wo, Wo, Wo, Wo, Wo, Wo, Wo, Wo, Wo, Wo, Wo, Wo, Wo, Wo, Wo, Wo, Wo, Wo, Wo, Wo, Wo, Wo, Wo, Wo, Wo, Wo, Wo, Wo, Wo, Wo, Wo, Wo, Wo, Wo, Wo, Wo, Wo, Wo, Wo, Wo, Wo, Wo, Wo, Wo, Wo, Wo, Wo, Wo, Wo, Wo, Wo, Wo, Wo, Wo, Wo, Wo, Wo, Wo, Wo, Wo, Wo
Wo, Wo, Wo, Wo, Wo, Wo, Wo, Wo, Wo, Wo, Wo, Wo, Wo, Wo, Wo, Wo, Wo, Wo, Wo, Wo, Wo, Wo, Wo, Wo, Wo, Wo, Wo, Wo, Wo, Wo, Wo, Wo, Wo, Wo, Wo, Wo, Wo, Wo, Wo, Wo, Wo, Wo, Wo, Wo, Wo, Wo, Wo, Wo, Wo, Wo, Wo, Wo, Wo, Wo, Wo, Wo, Wo, Wo, Wo, Wo, Wo, Wo
Wo, Wo, Wo, Wo, Wo, Wo, Wo, Wo, Wo, Wo, Wo, Wo, Wo, Wo, Wo, Wo, Wo, Wo, Wo, Wo, Wo, Wo, Wo, Wo, Wo, Wo, Wo, Wo, Wo, Wo, Ww, Ww, Ww, Ww, Ww, Ww, Ww, Ww, Ww, Wo, Wo, Wo, Wo, Wo, Wo, Wo, Wo, Wo, Wo, Wo, Wo, Wo, Wo, Wo, Wo, Wo, Wo, Wo, Wo, Wo, Wo, Wo
Wo, Wo, Wo, Wo, Wo, Wo, Wo, Wo, Wo, Wo, Wo, Wo, Wo, Wo, Wo, Wo, Wo, Wo, Wo, Wo, Wo, Wo, Wo, Wo, Wo, Ww, Ww, Ww, Ww, Ww, Ww, Ww^Vm, Ww, Ww, Ww, Ww, Ww, Ww, Ww, Ww, Wo, Wo, Wo, Wo, Wo, Wo, Wo, Wo, Wo, Wo, Wo, Wo, Wo, Wo, Wo, Wo, Wo, Wo, Wo, Wo, Wo, Wo
Wo, Wo, Wo, Wo, Wo, Wo, Wo, Wo, Wo, Wo, Wo, Wo, Wo, Wo, Wo, Wo, Wo, Wo, Wo, Wo, Wo, Wo, Wo, Wo, Ww, Ww, Ww, Ww, Ww, Ww, Ww, Ww, Ww, Ww, Ww, Ww, Ww, Ww, Ww, Ww, Ww, Ww, Ww, Ww, Ww, Ww, Wo, Wo, Ww, Ww, Ww, Ww, Ww, Ww, Ww, Wo, Wo, Wo, Wo, Wo, Wo, Wo
Wo, Wo, Wo, Wo, Wo, Wo, Wo, Wo, Wo, Wo, Wo, Wo, Wo, Wo, Wo, Wo, Wo, Wo, Wo, Wo, Wo, Wo, Ww, Ww, Ww, Ww, Ww, Ww^Vm, Ww, Ww, Ww, Ww, Ww, Ww, Ww, Ww, Ww, Ww, Ww, Ww, Ww, Ww, Ww, Ww^Vm, Ww, Ww, Ww, Ww, Ww, Ww^Vm, Ww, Ww, Ww, Ww^Vm, Ww, Wo, Wo, Wo, Wo, Wo, Wo, Wo
Wo, Wo, Wo, Wo, Wo, Wo, Wo, Wo, Wo, Wo, Wo, Wo, Wo, Wo, Wo, Ww, Ww, Wo, Ww, Ww, Ww, Ww, Ww, Ww, Ww, Ww, Ww, Ww, Ww, Ww, Ww, Ww, Ww, Gs, Gs, Gs^Fp, Gs^Ve, Gs^Fp, Gs^Fp, Gs^Fp, Ww, Ww, Gs^Fmw, Ww, Ww, Ww, Ww, Ww, Ww, Ww, Ww, Ww, Ww, Ww, Ww, Ww, Ww, Ww, Ww, Ww, Wo, Wo
Wo, Wo, Wo, Wo, Wo, Wo, Wo, Ww, Ww, Ww^Bw\, Ww^Bw\, Ww, Ww, Ww^Bw\, Ww^Bw\, Ww, Ww, Ww, Ww, Ww, Ww, Ww, Ww, Ww, Ww, Ww, Ww, Ww, Gs^Fp, Gs^Fp, Gs, Gs, Gs, Gs, Gs, Gs^Fp, Gs^Fp, Ww, Ww, Ch, Ch, Ch, Gs^Fmw, Gs^Fmw, Ww, Ww, Ww, Ww, Ww, Ww, Ww, Ww, Ww, Ww, Ww, Ww, Ww, Ww, Ww, Ww, Ww, Wo
Wo, Wo, Wo, Wo, Wo, Wo, Wo^Bw\, Wo, Ww^Vm, Ww, Ww, Ww^Bw\, Ww^Bw\, Ww, Gg, Ww^Bw\, Gg, Ww, Ww, Ww, Ww, Gs^Fp, Gs, Gs, Ww, Gs, Gs, Gs, Gs^Fp, Gs^Ve, Gs^Fp, Gs^Fp, Gs, Gs, Gs, Gs^Fp, Gs, Gs, Gs, Ch, 5 Kh, Ch, Gs^Fmw, Gs^Fmw, Gs, Gs, Ww, Ww, Ww, Ww, Ww, Ww, Ww, Ww, Ww, Ww, Ww, Ww, Ww, Ww, Ww, Ww
Wo, Wo, Wo, Wo, Wo^Bw\, Wo, Wo, Ww^Bw\, Ww^Bw\, Ww, Gg, Gg, Gg, 1 Gg, Gg, Gg, Gg, Gs^Fp, Gs, Gs^Fp, Ww, Ww, Ww, Gs^Fp, Gs, Gs, Gs, Gs, Gs, Gs^Fp, Gs^Fp, Gs^Fp, Gs, Gs, Gs, Gs^Fp, Gs, Gs, Gs, Gs^Fp, Ch, Rr, Gs, Gs, Gs, Gs, Gs^Fp, Ww, Gs^Fp, Gs^Fp, Gs, Ww, Gs, Gs^Fp, Ww, Ww, Ww, Ww, Ww, Ww, Ww, Ww
Wo, Wo, Wo, Wo, Wo, Wo^Bw\, Wo^Bw\, Ww, Gg, 2 Gg, Gg, Gg, Gg, Gg, Gs, Gs, Gs, Gs, Gs^Fp, Ww, Ww, Gs, Gs, Gs^Vh, Gs^Fp, Gs, Gs^Fp, Gs, Gs, Gs^Fp, Gs^Fp, Gs^Fp, Gs^Fp, Gs^Fp, Gs, Gs, Gs, Gs, Gs, Gs^Fp, Gs^Fp, Rr, Gs, Gs, Gs, Gs, Ww, Ww, Gs^Vh, Gs, Gs, Gs, Gs, Ww, Ww, Ww, Ww, Ww, Ww, Ww, Ww, Ww
Wo, Wo, Wo, Wo, Wo, Wo, Ww, 3 Gg, Gg, Gg, Gg, Gg, Ch, Ch, Ch, Gs, Gs^Vh, Gs, Gs^Ve, Ww, Gs, Gs, Gs, Gs, Gs^Fp, Gs, Gs^Fp, Gs, Gs, Gs, Gs^Fp, Gs^Ve, Gs^Fp, Gs, Gs, Gs, Gs^Fp, Gs^Fp, Gs^Fp, Gs^Ve, Gs, Rr, Gs, Gs, Gs^Fp, Gs^Fp, Ww, Gs, Gs, Gs, Gs, Gs, Gs, Gs, Ww, Ww, Ww, Ww, Ww, Ww, Ww, Ww
Wo, Wo, Wo, Wo, Wo, Wo, Ww, Gg, Gg, Gs, Gs, Gs, Ch, 4 Kh, Ch, Gs, Gs, Gs^Fp, Gs^Fp, Gs^Fp, Gs, Gs, Gs, Gs, Gs, Gs, Gs^Fp, Gs^Fp, Gs, Gs, Gs, Gs^Fp, Gs, Gs, Gs, Hh, Hh, Hh, Hh, Gs^Fp, Gs, Rr, Gs^Fp, Gs^Fp, Gs^Fp, Gs^Fp, Gs^Vh, Ww, Gs, Gs, Gs, Gs, Gs, Gs^Fp, Gs^Ve, Ww, Ww, Ww, Ww, Ww, Ww, Ww
Wo, Wo, Wo, Wo, Wo, Ww, Ww, Gs, Gs, Gs, Gs, Gs, Gs, Ch, Gs, Gs, Gs^Fp, Gs, Gs, Gs^Fp, Gs^Fp, Gs, Gs^Vh, Gs^Fp, Gs, Gs, Gs^Fp, Gs^Fp, Gs, Gs, Gs, Gs, Hh, Hh, Hh, Hh, Mm, Hh, Hh, Hh, Hh, Rr, Rr, Gs^Fp, Gs, Gs, Gs, Ww, Ww, Gs, Gs, Gs, Gs^Fp, Gs^Fp, Gs^Fp, Gs^Fp, Ww, Ww, Ww, Ww, Ww, Ww
Ww, Wo, Wo, Ww, Ww, Ww, Gs, Gs, Gs, Gs, Gs^Fp, Gs^Fp, Gs^Fp, Gs, Gs, Gs, Gs^Fp, Gs, Gs, Gs, Gs, Gs, Gs, Gs, Gs, Gs, Gs^Fp, Gs^Fp, Gs^Fp, Gs, Gs, Hh, Hh, Hh, Mm, Mm, Mm, Mm, Mm, Hh, Hh, Gs, Gs, Rr, Gs^Fp, Gs, Gs, Ww, Ww, Gs^Fp, Gs^Fp, Gs^Fp, Gs, Gs, Gs^Fp, Gs^Fp, Gs, Gs, Ww, Ww, Ww, Ww
Ww, Ww, Ww, Ww, Gs, Gs^Fp, Gs^Fp, Gs^Fp, Gs^Fp, Gs^Fp, Gs, Gs, Gs, Gs, Gs, Gs, Gs, Gs, Gs, Gs, Gs, Gs, Gs, Gs, Gs^Fp, Gs^Fp, Gs, Gs, Gs, Gs^Fp, Hh, Hh, Mm, Mm, Mm, Mm, Mm, Mm, Mm, Hh, Gs, Gs, Gs, Rr, Rr, Gs, Ww, Ww, Gs^Vh, Gs, Gs^Fp, Gs^Fp, Gs, Gs, Gs^Fp, Gs^Ve, Gs^Fp, Gs, Gs, Ww, Ww, Ww
Ww, Ww, Ww, Gs^Fp, Gs^Ve, Gs^Ve, Gs, Gs, Gs, Gs^Fp, Gs, Gs, Gs^Vh, Gs, Rr, Rr, Rr, Rr, Rr, Gs, Gs, Gs, Gs, Gs, Gs, Gs, Gs, Gs, Gs, Hh, Hh, Mm, Mm, Mm, Ms^Vhh, Mm, Mm, Mm, Hh, Hh, Gs, Gs, Gs, Gs, Rr, Ww, Ww, Gs^Fp, Gs, Gs, Gs, Gs^Fp, Gs, Ch, Ch, Ch, Gs^Fp, Gs^Fp, Gs, Gs, Gs, Ww
Gs^Fp, Gs^Fp, Ww, Gs^Fp, Gs^Fp, Gs^Fp, Gs, Gs, Rr, Gs, Gs^Fp, Gs, Rr, Rr, Gs, Gs, Gs, Gs, Gs^Fp, Rr, Rr, Gs, Gs, Gs, Gs, Gs, Gs, Gs, Hh, Hh, Hh, Mm, Mm, Ww, Ww, Ww, Mm, Hh, Hh, Gs, Gs, Gs, Gs, Gs^Vh, Rr, Ww, Rr, Ww, Gs^Fp, Gs, Gs, Gs^Fp, Gs, Ch, 9 Kh, Ch, Gs, Gs^Fp, Gs, Gs, Gs, Gs
Gs^Fp, Gs^Fp, Ww, Gs^Fp, Gs^Fp, Gs^Fp, Gs, Rr, Gs, Rr, Rr, Rr, Gs, Gs, Gs, Gs, Gs, Gs^Fp, Gs^Fp, Gs^Ve, Rr, Gs, Gs, Gs^Fp, Gs, Gs, Gs, Hh, Hh, Hh, Mm, Mm, Ww, Ww, Ww, Ww, Ww, Hh, Gs, Gs, Gs, Gs, Gs, Gs, Gs, Rr, Ww, Ch, Gs^Fp, Gs^Fp, Gs^Fp, Gs^Fp, Gs, Gs^Fp, Ch, Rr, Rr, Gs, Gs, Gs, Gs, Gs
Gs, Gs^Vh, Ww, Gs, Gs^Fp, Gs^Fp, Gs^Fp, Rr, Gs^Fp, Gs^Fp, Gs^Fp, Gs^Fp, Hh, Hh, Hh, Hh, Hh, Gs^Fp, Gs^Fp, Gs^Fp, Gs^Fp, Rr, Gs, Gs, Gs, Gs, Gs, Gs, Hh, Hh, Hh, Mm, Ww, Ww, Ww, Ww, Ww, Gs, Gs, Gs, Gs, Gs, Gs, Gs, Gs, Ww, Ww, Rr, Rr, Gs, Gs, Gs, Gs, Gs^Fp, Gs^Fp, Gs^Fp, Rr, Gs^Fp, Gs^Vh, Gs, Gs, Gs
Gs, Ww, Gs^Fp, Ch, Ch, Ch, Rr, Rr, Hh, Hh, Hh, Hh^Vhh, Hh, Mm, Mm, Hh, Hh, Hh, Gs^Fp, Gs^Fp, Gs, Rr, Gs, Gs, Gs, Gs^Fp, Gs^Fp, Gs^Fp, Hh, Hh, Hh^Vhh, Ww, Ww, Ww, Ww, Ww, Ww, Ww, Gs, Gs, Gs, Gs, Gs, Gs, Gs, Ww, Ww, Gs, Rr, Gs, Gs, Gs, Gs, Gs, Gs, Gs^Fp, Gs^Fp, Rr, Rr, Gs, Gs^Fp, Gs
Gs^Fp, Gs^Fp, Gs^Fp, Ch, 6 Kh, Ch, Rr, Gs^Fp, Hh, Hh, Hh, Hh, Mm, Mm, Mm, Mm, Mm, Hh, Gs^Fp, Gs^Fp, Gs^Fp, Rr, Gs, Gs, Gs, Gs^Fp, Gs^Ve, Gs^Fp, Hh, Hh, Hh, Ww, Ww, Ww, Ww, Ww, Ww, Ww, Ww, Gs^Fp, Ww, Gs, Ww, Gs, Gs, Ww, Ww, Gs, Rr, Gs, Gs, Gs, Gs, Gs, Gs, Gs, Gs, Gs, Gs^Fp, Rr, Rr, Gs
Gs^Fp, Gs^Fp, Ww, Gs, Ch, Rr, Gs^Fp, Gs^Ve, Gs^Fp, Hh, Hh, Mm, Mm, Mm, Mm, Mm, Mm, Mm, Hh, Gs, Gs, Rr, Rr, Gs, Gs, Gs^Fp, Gs^Fp, Gs^Fp, Gs^Fp, Hh, Hh, Hh, Ww, Ww, Ww, Ww, Ww, Gs, Gs, Ww, Gs, Ww, Ww, Gs, Ww, Ww, Gs, Gs^Vh, Rr, Gs, Gs, Gs, Gs, Gs, Gs, Gs, Gs, Gs, Gs, Gs, Rr, Gs^Fp
Gs^Fp, Gs^Fp, Ww, Ww, Gs, Gs^Fp, Gs, Gs, Hh, Hh, Mm, Mm, Mm, Mm, Mm, Mm, Mm, Mm, Hh, Hh, Gs, Gs, Gs^Vh, Rr, Gs, Gs^Fp, Gs^Fp, Gs^Fp, Gs^Fp, Gs, Gs^Fp, Gs, Ww, Gs^Fp, Ww, Gs^Vh, Gs, Gs, Gs, Gs, Ww, Ww, Ww, Ww, Ww, Gs^Fp, Gs, Gs, Gs, Rr, Rr, Gs, Gs, Gs, Gs^Fp, Gs, Gs, Gs, Gs, Gs, Rr, Gs^Fp
Gs^Fp, Gs^Fp, Gs, Ww, Ww, Gs^Fp, Gs^Fp, Gs, Hh, Mm, Mm, Mm, Mm, Mm, Mm, Mm, Mm, Mm, Hh, Hh, Gs, Gs, Gs, Rr, Gs, Gs^Fp, Gs^Fp, Gs, Gs, Gs^Fp, Gs^Fp, Gs, Gs, Gs^Vh, Ww, Gs, Ww, Gs, Ww, Gs, Ww, Gs, Gs^Vh, Ww, Ww, Gs^Fp, Gs, Gs, Gs, Gs, Rr, Gs^Fp, Gs^Fp, Gs^Fp, Gs^Ve, Gs^Fp, Gs, Gs, Gs, Gs^Fp, Rr, Gs
Gs, Gs^Fp, Gs^Fp, Ww, Ww, Gs^Fp, Gs^Fp, Gs^Fp, Hh, Mm, Mm, Mm, Mm, Mm, Mm, Mm, Mm, Mm, Hh, Hh, Gs, Gs, Gs, Rr, Rr, Rr, Rr, Gs, Gs^Fp, Gs^Fp, Gs, Gs, Gs, Gs, Ww, Gs^Fp, Ww, Ww, Ww, Ww, Ww, Ww, Ww, Gs, Ww, Gs^Fp, Gs, Gs, Gs, Gs^Fp, Gs^Fp, Rr, Gs, Gs, Gs^Fp, Gs^Fp, Gs, Gs, Gs, Gs^Fp, Rr, Gs
Gs, Gs^Fp, Gs^Fp, Ww, Ww, Ww, Gs, Hh, Mm, Mm, Mm, Mm, Mm, Mm, Mm, Mm, Mm, Mm, Mm, Hh, Gs, Gs, Gs, Gs, Gs, Gs^Vh, Gs, Rr, Rr, Rr, Rr, Gs, Gs, Gs, Gs^Fp, Gs^Fp, Ww, Ww, Ww, Gs^Fp, Ww, Ww, Ww, Ww, Ww, Gs, Gs, Gs, Gs, Gs^Fp, Gs^Fp, Rr, Rr, Gs, Gs^Fp, Gs, Gs, Gs, Gs, Gs^Fp, Rr, Gs
Gs, Gs, Ww, Ww, Gs^Vh, Ww, Gs^Vh, Hh, Mm, Mm, Mm, Mm, Ms^Vhh, Mm, Mm, Mm, Mm, Mm, Mm, Hh, Gs, Gs^Fp, Gs^Fp, Gs^Fp, Gs, Gs, Gs, Gs, Gs, Gs^Fp, Gs, Rr, Rr, Gs^Fp, Gs^Fp, Gs^Vh, Gs^Fp, Ww, Ww, Gs, Ww, Ww, Ww, Ww, Ww, Gs, Gs^Vh, Gs, Gs, Gs, Gs^Fp, Gs, Rr, Gs, Gs^Fp, Gs, Gs, Gs, Gs^Fp, Rr, Gs^Vh, Gs
Gs, Gs, Ww, Gs, Gs, Ww, Ww, Mm, Ww, Mm, Mm, Mm, Mm, Mm, Mm, Mm, Mm, Mm, Mm, Hh, Hh, Gs^Ve, Gs, Gs^Fp, Gs^Fp, Gs, Gs, Gs, Gs, Gs^Fp, Gs^Fp, Gs^Fp, Gs, Rr, Rr, Rr, Rr, Gs^Fp, Rr, Ww, Ww, Ww, Ww, Ww, Gs^Fp, Ww, Gs, Gs, Gs, Gs, Gs^Fp, Gs, Rr, Gs^Fp, Gs, Gs, Gs^Fp, Gs^Fp, Gs^Fp, Rr, Gs, Gs
Gs, Ww, Ww, Gs, Gs, Hh, Mm, Ww, Ww, Mm, Mm, Mm, Mm, Mm, Mm, Mm, Mm, Mm, Mm, Mm, Hh, Gs^Fp, Gs^Fp, Gs, Gs, Gs^Fp, Gs^Fp, Gs, Gs^Fp, Gs^Fp, Gs^Fp, Gs, Gs, Gs, Gs, Gs, Gs^Fp, Rr, Gs, Rr, Rr, Gs^Vh, Gs^Fp, Ww, Gs, Ww, Gs^Fp, Gs, Gs, Gs, Gs, Gs, Gs^Fp, Rr, Rr, Gs, Gs, Gs, Gs, Rr, Gs, Gs
Ww, Ww, Ww, Gs, Gs, Hh, Mm, Ww, Ww, Ww, Mm, Mm, Mm, Mm, Mm, Mm, Mm, Mm, Mm, Mm, Hh, Gs, Gs^Fp, Gs^Fp, Gs, Gs^Fp, Gs^Fp, Gs^Fp, Gs^Fp, Gs^Vh, Gs, Gs, Gs, Gs, Hh, Gs, Gs^Fp, Gs^Fp, Gs, Gs, Gs, Rr, Rr, Gs, Gs, Ww, Ww, Gs^Fp, Gs, Gs, Gs, Gs, Gs, Gs, Gs^Vh, Rr, Rr, Gs, Gs, Rr, Gs, Gs
Ww, Ww, Gs^Fp, Gs, Hh, Mm, Mm, Ww, Ww, Ww, Ww, Ww, Mm, Mm, Mm, Mm, Mm, Mm, Mm, Mm, Hh, Hh, Gs, Gs^Fp, Gs^Fp, Gs^Ve, Gs^Fp, Gs^Fp, Gs, Gs, Gs, Gs, Gs, Hh, Hh, Hh, Hh, Gs^Fp, Gs, Gs, Gs, Gs, Rr, Gs^Fp, Rr, Ww, Rr, Gs^Fp, Rr, Gs, Gs, Gs, Rr, Rr, Rr, Ch, Ch, Ch, Gs, Rr, Gs, Gs
Ww, Gs^Fp, Gs^Fp, Hh, Mm, Mm, Mm, Ww, Ww, Ww, Ww, Ww, Mm, Mm, Mm, Mm, Mm, Mm, Mm, Mm, Hh, Hh, Gs, Gs, Gs^Fp, Gs^Fp, Gs, Gs^Fp, Gs, Gs, Gs, Hh, Hh, Hh, Hh, Hh, Hh, Hh, Hh, Gs^Fp, Gs^Fp, Gs^Fp, Gs^Fp, Rr, Ww, Ch, Ww, Rr, Gs^Fp, Rr, Rr, Rr, Gs, Gs^Fp, Gs^Fp, Ch, 8 Kh, Ch, Gs^Fp, Rr, Gs, Gs
Gs^Fp, Gs^Fp, Gs^Fp, Hh, Mm, Mm, Mm, Mm, Ww, Ww, Ww, Ww, Ms^Vhh, Mm, Mm, Mm, Mm, Mm, Mm, Mm, Hh, Hh, Gs, Gs, Gs, Gs^Fp, Gs^Fp, Gs^Fp, Gs, Gs, Hh, Hh, Hh, Hh, Hh, Hh^Vhh, Hh, Hh, Hh, Hh, Gs, Gs, Gs^Fp, Ww, Ww, Ww, Ww, Gs^Vh, Ww, Ww, Ww, Gs^Fp, Gs, Gs^Fp, Gs^Fp, Gs, Ch, Rr, Gs^Fp, Rr, Gs, Gs
Gs, Gs, Hh, Hh, Mm, Mm, Mm, Mm, Ww, Ww, Ww, Ww, Mm, Mm, Mm, Mm, Mm, Mm, Mm, Mm, Hh, Gs^Fp, Gs^Fp, Gs, Gs, Gs, Gs, Gs, Gs, Gs, Hh, Hh, Hh, Mm, Hh, Hh, Mm, Hh, Hh, Hh, Gs, Gs, Gs, Ww, Ww, Ww, Ww, Ww, Ww, Gs^Fp, Ww, Gs^Fp, Gs, Gs^Fp, Gs^Fp, Gs, Gs, Rr, Rr, Rr, Gs, Gs
Ww, Hh, Hh, Mm, Mm, Mm, Mm, Mm, Mm, Ms^Vhh, Mm, Mm, Mm, Mm, Mm, Mm, Mm, Mm, Mm, Hh, Hh, Gs^Fp, Gs^Fp, Gs, Gs, Gs, Gs, Gs, Gs^Vh, Hh, Hh, Hh, Hh, Hh, Hh, Mm, Mm, Mm, Hh, Hh, Gs, Gs, Gs, Gs^Fp, Ww, Ww, Ww, Ww, Ww, Ww, Gs^Fp, Ww, Gs^Fp, Gs^Fp, Gs, Gs, Rr, Rr, Rr, Hh, Hh, Hh
Ww, Hh, Hh, Mm, Mm, Mm, Mm, Mm, Mm, Mm, Mm, Mm, Mm, Mm, Mm, Mm, Mm, Mm, Hh, Gs, Gs^Fp, Gs^Fp, Gs^Fp, Gs^Fp, Gs^Fp, Gs^Fp, Gs^Fp, Gs, Gs, Hh, Hh, Hh, Hh, Mm, Mm, Mm, Mm, Mm, Hh, Hh, Gs, Gs, Gs, Gs^Vh, Ww, Ww, Gs^Fp, Ww, Ww, Ww, Gs, Ww, Gs, Gs, Rr, Rr, Hh, Hh, Rr, Hh, Hh, Hh
Ww, Hh, Hh, Mm, Mm, Mm, Mm, Mm, Mm, Mm, Mm, Mm, Mm, Mm, Mm, Mm, Hh, Hh, Gs, Gs^Vh, Gs, Gs^Fp, Gs, Gs, Gs, Gs, Gs, Gs, Hh, Hh, Hh, Hh, Mm, Mm, Mm, Mm, Mm, Mm, Hh, Hh, Gs^Fp, Gs, Gs, Gs, Ww, Gs, Ww, Ww, Ww, Gs, Gs, Ww, Gs, Gs, Rr, Gs^Fp, Hh, Hh, Rr, Hh, Mm, Hh
Ww, Hh, Hh, Mm, Mm, Mm, Mm, Mm, Mm, Mm, Mm, Mm, Mm, Mm, Hh, Hh, Gs, Gs^Fp, Gs^Fp, Gs, Gs, Gs, Gs, Gs, Gs, Gs, Gs, Gs, Hh, Hh, Hh, Hh, Hh, Hh, Hh, Mm, Mm, Hh, Hh, Gs, Gs, Gs, Gs, Gs, Ww, Ww, Ww, Ww, Ww, Ww, Gs^Vh, Ww, Gs^Fp, Gs, Rr, Gs^Vh, Rr, Rr, Mm, Mm, Mm, Mm
Ww, Hh, Hh, Mm, Mm, Mm, Mm, Mm, Mm, Mm, Mm, Mm, Hh, Hh, Gs, Gs, Gs, Gs^Vh, Gs^Fp, Gs, Gs, Gs, Gs, Gs, Gs^Vh, Gs, Gs, Gs, Hh, Hh, Hh, Hh, Hh, Hh, Hh, Mm, Hh, Hh, Hh, Gs, Gs^Fp, Gs^Fp, Rr, Rr, Rr, Ww, Ww, Ww, Ww^Bw/, Rr, Rr, Ww, Gs^Fp, Gs, Rr, Rr, Hh, Hh, Mm, Mm, Mm, Mm
Ww, Hh, Hh, Hh, Hh, Mm, Ww, Ww, Ww, Ww, Hh^Vhh, Hh, Hh, Gs^Ve, Gs^Fp, Gs, Gs, Gs, Gs^Fp, Gs, Gs, Gs, Gs, Gs, Gs, Gs, Gs, Gs, Gs^Fp, Gs^Fp, Gs, Hh, Hh, Hh, Hh, Hh, Hh, Hh, Hh, Gs^Fp, Gs^Fp, Rr, Gs^Fp, Gs^Fp, Gs^Fp, Rr, Rr, Ww^Bw/, Ww, Ww, Ww, Ch, Gs^Fp, Gs^Fp, Rr, Rr, Hh, Hh, Hh, Mm, Mm, Mm
Hh, Hh, Hh, Hh, Hh, Hh, Ww, Ww, Ww, Ww, Ww, Gs, Gs^Fp, Gs^Fp, Gs^Fp, Gs^Fp, Gs, Gs^Fp, Gs, Gs, Gs, Ch, Ch, Ch, Gs, Gs, Gs, Gs, Gs^Fp, Gs, Gs, Gs, Gs^Fp, Gs^Fp, Hh, Hh, Hh, Hh, Gs^Fp, Ch, Ch, Ch, Gs, Gs, Gs^Fp, Ww, Ww, Gs, Ww, Gs^Fp, Gs, Gs, Rr, Rr, Gs^Vh, Gs, Gs, Hh, Hh, Hh, Mm, Mm
Hh, Hh, Hh, Hh, Ww, Ww, Ww, Ww, Ww, Ww, Ww, Gs, Gs, Gs^Fp, Gs^Fp, Gs^Fp, Gs^Fp, Gs, Gs, Gs, Gs, Ch, Kh, Ch, Gs, Gs, Gs^Fp, Gs^Fp, Gs^Fp, Gs^Fp, Gs, Gs, Gs, Gs^Ve, Gs^Fp, Gs^Fp, Gs^Fp, Gs^Fp, Gs^Fp, Ch, 7 Kh, Ch, Gs^Fp, Gs^Fp, Gs^Ve, Ww, Ww, Ww, Ww, Gs, Rr, Rr, Gs, Gs, Gs, Gs, Gs, Gs, Hh, Hh, Hh, Mm
Hh, Ww, Ww, Ww, Hh, Ww, Ww, Ww, Ww, Ww, Ww, Gs, Gs, Gs, Gs, Gs, Gs, Gs, Gs, Gs, Gs, Gs, Ch, Gs, Rr, Gs^Fp, Gs^Fp, Gs^Fp, Gs^Fp, Gs^Fp, Gs, Gs, Gs, Gs^Fp, Gs^Fp, Gs^Fp, Gs^Ve, Gs^Fp, Gs^Fp, Gs^Fp, Ch, Gs^Fp, Gs^Fp, Gs^Fp, Gs^Fp, Ww, Ww, Ww, Ww, Ch, Ww, Gs, Gs, Gs, Gs, Gs, Gs, Gs, Gs, Hh, Hh, Mm
Ww, Ww, Ww, Ww, Ww, Ww, Ww, Ww, Ww, Ww, Gs^Vh, Gs, Gs, Gs, Gs, Gs, Gs, Gs, Gs, Gs, Gs, Gs, Gs, Rr, Gs, Rr, Rr, Rr, Rr, Gs, Gs, Gs, Gs, Gs, Gs^Fp, Gs^Fp, Gs^Fp, Gs^Fp, Gs^Fp, Gs^Fp, Gs, Gs, Gs, Gs, Ww, Ww, Ww, Ww, Rr, Rr, Gs, Ww, Ww, Gs, Gs, Gs, Gs^Fp, Gs^Fp, Gs, Hh, Hh, Mm
Ww, Ww, Hh, Ww, Ww, Ww, Ww, Ww, Ww, Ww, Gs, Gs, Gs, Gs, Gs, Gs, Gs, Gs, Gs, Gs, Gs, Gs, Gs, Gs, Gs, Gs, Gs, Gs, Gs, Rr, Rr, Gs, Gs, Gs, Gs, Gs, Gs, Gs, Rr, Gs, Rr, Gs, Gs, Gs, Gs, Ww, Ww, Ww, Rr, Gs, Gs^Fp, Gs^Vh, Ww, Gs, Gs, Gs, Gs^Fp, Gs^Fp, Gs, Hh, Hh, Mm
Hh, Hh, Hh, Hh, Ww, Ww, Gs^Vh, Ww, Ww, Gs, Gs, Gs, Gs, Gs, Gs, Gs, Gs, Gs, Gs, Gs, Gs^Fp, Gs^Fp, Gs^Fp, Gs, Gs, Gs, Gs^Fp, Gs^Fp, Gs, Gs, Gs, Rr, Rr, Rr, Rr, Gs^Vh, Rr, Rr, Gs, Rr, Gs, Rr, Rr, Gs, Gs, Gs^Vh, Rr, Gs, Rr, Gs, Gs, Gs, Ww, Gs, Gs^Fp, Gs, Gs, Gs, Gs, Gs^Vh, Hh, Mm
Ww, Gs^Fp, Gs^Fp, Gs^Fp, Gs^Fp, Gs^Fp, Ww, Ww, Gs, Gs, Gs, Gs, Gs, Gs, Gs, Gs, Gs, Gs, Gs, Gs, Gs, Gs^Fp, Gs^Fp, Gs^Fp, Gs^Fp, Gs^Fp, Gs^Fp, Gs^Fp, Gs^Fp, Gs^Fp, Gs, Gs, Gs, Gs, Gs, Rr, Gs, Gs, Gs, Gs, Gs, Gs, Gs, Rr, Rr, Rr, Gs, Rr, Gs, Gs, Gs, Gs, Ww, Gs, Gs, Gs, Gs, Gs, Gs, Gs, Hh, Mm
