Gg, Gg, Gg, Gll^Fp, Gll^Fp, Ww, Ww, Ww, Ww, Gg, Gg, Gg, Gg, Gg, Gg, Gg, Gg, Gg, Gll^Fp, Gll^Fp, Gll^Fp, Gg, Gg, Gll^Fdf, Gll^Fdf, Gll^Fdf, Gg, Gg, Gll^Fp, Gll^Fp, Gg, Gg, Gg, Gg, Gg, Gll^Fp, Gll^Fp, Gg, Gg, Gll^Fdf, Gg, Gg, Gg, Gg, Gg, Gll, Gg, Gg, Gg, Gg, Gg, Gg, Gll^Fp, Gll^Fp, Gll^Fp, Gll^Fp, Gll^Fp, Gg, Gg, Gll^Fp, Gg, Gg
Gg, Gll^Fp, Gll^Fp, Gll^Fp, Gll, Ww, Gll, Ww, Ww, Gg, Gg, Gg, Gg, Gg, Gg, Gg, Gll^Fp, Gll^Fp, Gll^Fp, Gll^Fp, Gll^Fp, Gll^Fp, Gg, Gll^Fdf, Gll^Fdf, Gll^Fdf, Gg, Gg^Vh, Gll^Fp, Gg, Gll^Fp, Gll^Fp, Gg, Gg, Gg, Gg, Gg^Vh, Gg, Gg, Gll^Fdf, Gg, Gg, Gg, Gg, Gg, Gg, Gg, Gg, Rr, Gg, Gll^Fp, Gg, Gg, Gg, Gg, Gll^Fp, Gll^Fp, Gll^Fp, Gg, Gll^Fp, Gg, Gg
Gg, Gg, Gg, Gll^Fp, Ww, Ww, Gll, Ww, Gll, Gg, Gg, Gll^Fp, Gll^Fp, Gg, Gg, Gg, Gll^Fp, Gg, Gg, Gg, Gll^Fp, Gg, Gg, Gll^Fdf, Gll^Fdf, Gll^Fdf, Gll^Fdf, Gg, Gll^Fp, Gg, Rr, Gll^Fp, Rr, Rr, Rr, Gg, Rr, Rr, Gll^Fdf, Gll^Fdf, Gg, Gg, Rr, Rr, Rr, Rr, Rr, Rr, Gg^Vh, Rr, Rr, Gg, Gg^Vh, Gg, Gll^Fp, Gll^Fp, Gll^Fp, Gll^Fp, Gg, Gg, Hh, Gll^Fp
Gg, Gg, Ww, Ww, Gll^Fp, Ww, Gll, Gll, Gll^Fp, Gll^Fp, Gg, Gll^Fp, Gll^Fp, Gll^Fp, Gg, Gg, Gg, Gg, Gg, Gg, Gg, Gll^Fp, Gg, Gll^Fdf, Gll^Fdf, Gll^Fdf, Gll^Fdf, Gg, Rr, Gg, Gg, Gg, Gg, Gg, Gg, Rr, Gg, Gll^Fdf, Gll^Fdf, Rr, Rr, Rr, Gg, Gg^Vh, Gg, Gg, Gg, Gll^Fp, Gll^Fp, Gll^Fp, Gg, Rr, Rr, Gg, Gll^Fp, Gll^Fp, Gll^Fp, Gll^Fp, Gg, Hh, Gg, Gg
Ww, Ww, Ww, Gg, Gg, Gg, Ss, Ss, Ss, Gll^Fp, Gg, Gg, Gg, Gll^Fp, Gll^Fp, Gg, Gll^Fp, Gll^Fp, Gg, Gg, Gg, Gg, Gg, Gll^Fdf, Gll^Fdf, Gll^Fdf, Gll^Fdf, Gg, Rr, Gg, Gg, Gg, Gll^Fp, Gll^Fp, Gg, Gg, Gg, Gll^Fdf, Gll^Fdf, Gg, Gg, Gg, Gg, Gg, Gg, Gg, Gll^Fp, Gll^Fp, Gll^Fp, Gll^Fp, Gg, Gg, Gg, Rr, Rr, Gg, Gg, Gg, Gll^Fp, Gll^Fp, Gg, Gg
Ww, Ww, Gg, Gg, Gg, Gg, Gll^Fp, Gg, Ss, Gll^Fp, Gll^Fp, Gg, Gg, Gll^Fp, Gg, Gg, Gg, Gll^Fp, Gg, Gg, Gg, Gg, Gg, Gg, Gll^Fdf, Gll^Fdf, Gll^Fdf, Rr, Gg, Gg, Gg, Gll^Fp, Gg^Ve, Gll^Fp, Gg^Vh, Gg, Gg, Gll^Fdf, Gll^Fdf, Gg, Gg, Gll^Fp, Gg, Gg, Gg, Gg, Gll^Fp, Gg, Gll^Fp, Gll^Fp, Gg, Gg, Gg, Gg, Gg, Rr, Rr, Gg, Gg, Gg, Gg, Gg
Gg, Gg, Gg, Gg, Gg, Rr, Rr, Gll^Fp, Gll^Fp, Gll^Fp, Gll^Fp, Gg, Gg, Gll^Fp, Gll^Fp, Gg, Gg^Vh, Gg, Gg, Gg, Gg, Gg, Gg, Gg^Vh, Rr, Rr, Gg, Gg, Gg, Gg, Rr, Gg, Gll^Fp, Gll^Fp, Gg, Gg, Gg, Gll^Fdf, Gll^Fdf, Gll^Fdf, Gg, Gg, Gg, Gg, Gg, Gg, Gg, Gll^Fp, Gg^Ve, Gll^Fp, Gg, Gg, Gg, Gg, Gg, Gg, Gg, Rr, Rr, Gg, Gg, Gg
Gg, Gg, Gg, Gg, Gll^Fp, Gll^Fp, Gll^Fp, Rr, Rr, Gg^Ve, Gll^Fp, Gg, Gll, Gg, Gg, Gg, Gg, Gg, Gg, Gg, Gg, Gg, Rr, Rr, Gg, Gg, Gg, Gg, Gg, Gg, Rr, Gg, Gg, Gg, Gg, Gg, Gll^Fdf, Gll^Fdf, Gll^Fdf, Gll^Fdf, Gll^Fdf, Gll^Fdf, Gll^Fdf, Gll^Fdf, Gg, Gg, Gg, Gg, Gll^Fp, Gll^Fp, Gg, Gg, Gg, Gg, Gg, Gg, Gg, Gll^Fp, Gll^Fp, Rr, Rr, Gg
Gg, Gg, Gll^Fp, Gll^Fp, Gll^Fp, Gll^Fp, Gll^Fp, Gll^Fp, Rr, Gll^Fp, Gll^Fp, Gll^Fp, Gg, Gll, Gg, Gg, Gg, Gg, Gg, Gg, Rr, Rr, Gll^Fp, Gg, Gll, Gll, Gg, Gg, Gg, Gg, Rr, Gll^Fp, Gg, Gg, Gg, Gg, Gll^Fdf, Gll^Fdf, Gll^Fdf, Gll^Fdf, Gll^Fdf, Gll^Fdf, Gll^Fdf, Gll^Fdf, Gg, Gg, Gg, Gg, Gll^Fp, Gll^Fp, Gg, Gg, Gg, Gg, Rr, Gg, Gg, Gg, Gll^Fp, Gll^Fp, Rr, Gll^Fp
Gg, Gg, Gll^Fp, Gg^Ve, Gll^Fp, Gll^Fp, Gll^Fp, Gg, Rr, Gg, Gg, Gll^Fp, Gll^Fp, Gll^Fp, Gg, Gg, Gg, Gg, Gg^Vh, Rr, Gg, Gg, Gll^Fp, Gll^Fp, Gll, Gll^Fp, Gg, Gg, Gg, Gg, Rr, Gll^Fp, Gg, Gg, Gg, Gll^Fdf, Gll^Fdf, Gll^Fdf, Gll^Fdf, Gll^Fdf, Gll^Fdf, Gll^Fdf, Gll^Fdf, Gg, Gg, Gg, Gg, Gg, Cer, Hh, Hh, Hh, Gg, Rr, Gg, Gg, Gg, Gg, Gll^Fp, Gll^Fp, Gll^Fp, Rr
Gll^Fp, Gll^Fp, Gll^Fp, Gll^Fp, Gll^Fp, Gll^Fp, Gll^Fp, Gg, Gg, Rr, Rr, Gg, Rr, Gll^Fp, Gll^Fp, Gg, Rr, Gg, Rr, Rr, Gll^Fp, Gg, Gll^Fp, Gll^Fp, Gll^Fp, Gg, Gg, Gg, Gg, Gg, Gg^Vh, Rr, Gg, Gg, Gll^Fdf, Gll^Fdf, Gll^Fdf, Gll^Fdf, Gll^Fdf, Gg, Gll^Fdf, Gll^Fdf, Gll^Fdf, Gll^Fdf, Gg, Gg, Gg, Cer, Ker, Hh, Hh, Hh, Rr, Rr, Gll^Fp, Gll^Fp, Gg, Gll^Fp, Gll^Fp, Gg^Ve, Gll^Fp, Rr
Ss, Ss, Ss, Gll^Fp, Gll^Fp, Gg, Gg, Gg, Hh, Gll^Fdf, Gll^Fdf, Rr, Gll^Fp, Rr, Rr, Rr, Gll^Fp, Rr, Gg, Gg, Gll^Fp, Gll^Fp, Gll^Fp, Gll^Fp, Gll^Fp, Gg, Gg, Gll^Fdf, Gll^Fdf, Gg, Gg, Rr, Rr, Gg, Gll^Fdf, Gll^Fdf, Gll^Fdf, Gll^Fdf, Gll^Fdf, Gll^Fdf, Gg, Gll^Fdf, Gll^Fdf, Gll^Fdf, Gll^Fdf, Gg, Gg, Cer, Cer, Cer, Rr, Rr, Gll^Fp, Gll^Fp, Gll^Fp, Gg, Gll^Fp, Gll^Fp, Gll^Fp, Gll^Fp, Gg, Gg
Ss, Ss, Gll^Fp, Gll^Fp, Gg, Gg, Gg, Hh, Hh, Hh, Rr, Rr, Gll^Fp, Gg, Gll^Fp, Gg^Ve, Gll^Fp, Gll^Fp, Gg, Gg, Gg, Gll^Fp, Gll^Fp, Gg^Ve, Gg, Gg, Gg, Gll^Fdf, Gll^Fdf, Gg, Gg, Gg, Rr, Gg, Gll^Fdf, Gll^Fdf, Gll^Fdf, Gll^Fdf, Gll^Fdf, Gll^Fdf, Gll^Fdf, Gll^Fdf, Gll^Fdf, Gll^Fdf, Gg, Gg, Gg, Gg, Gg, Rr, Gg, Gll^Fp, Gll^Fp, Gg, Gg, Gg, Gll^Fp, Gg^Ve, Gg, Gg, Gg, Gg
Gll, Gll, Gll^Fp, Gg, Gg, Gg, Gg, Gg, Rr, Rr, Gg, Rr, Rr, Gll^Fp, Gg, Gll^Fp, Gll^Fp, Gg, Gg, Gg, Gg, Gg, Gg, Gg, Gg, Gg, Gg, Gll^Fdf, Gll^Fdf, Gll^Fdf, Gll^Fdf, Gg, Rr, Gg, Gg, Gll^Fdf, Gll^Fdf, Gll^Fdf, Gll^Fdf, Gll^Fdf, Gll^Fdf, Gll^Fdf, Gll^Fdf, Gll^Fdf, Gll^Fdf, Gg, Gg, Gg, Gg, Rr, Gg, Gll^Fp, Gg, Gg, Gg, Gg, Gll^Fp, Gll^Fp, Gg, Gg, Gg, Gg
Gll, Gll, Gll^Fp, Gg, Gg, Gg, Gg^Vh, Rr, Gg, Gg, Gg, Gll^Fdf, Rr, Gll^Fp, Gll^Fp, Gll^Fp, Gll^Fp, Gg^Vh, Hh, Hh, Gll^Fp, Gg, Gg, Gg, Gg, Gg, Gg, Gg, Gg, Gll^Fdf, Gll^Fdf, Gll^Fdf, Rr, Gg, Gg^Vh, Gg, Gll^Fdf, Gll^Fdf, Gll^Fdf, Gll^Fdf, Gll^Fdf, Gll^Fdf, Gll^Fdf, Gll^Fdf, Gg, Gg, Gg^Vh, Gg, Rr, Rr, Gg, Gll^Fp, Gg, Gg, Gg, Gg, Gg, Gll^Fp, Gg, Gg, Gg, Gg
Gll, Gll, Gll^Fp, Gg, Gg, Gg, Rr, Rr, Gg, Gll^Fdf, Gg, Gll^Fdf, Gg, Rr, Rr, Gg, Gll^Fp, Gg, Gg, Hh, Gll^Fp, Gll^Fp, Gg, Gll^Fp, Gll^Fp, Gll^Fp, Gg, Gg, Gg, Gg, Gll^Fdf, Gll^Fdf, Rr, Gg, Gg, Gg, Gg, Gll^Fdf, Gll^Fdf, Gll, Gll^Fdf, Gll, Gll, Gll, Gg, Gg, Rr, Rr, Gg^Vh, Gll^Fdf, Gg, Gll^Fp, Gg, Gg, Gg, Gg, Gg, Gll^Fp, Gll^Fp, Gg, Gg, Gg
Rr, Gg, Gg^Vh, Gg, Rr, Rr, Gg, Gg, Gll^Fdf, Gll^Fdf, Gll^Fdf, Gll^Fdf, Gg, Gg, Rr, Gg, Gg, Gg, Hh, Gg, Gg, Gg, Gll^Fp, Gll^Fp, Gll^Fp, Gll, Gll, Gll, Gll, Gg, Ss^Bw\r, Ss^Bw|r, Ss^Bw/r, Gg, Gg, Gg, Gg, Gg, Gg, Gg, Gg, Gll, Gg, Gll^Fp, Gll^Fp, Gll^Fp, Rr, Gg, Gg, Gll^Fdf, Gg, Gll^Fp, Gll^Fp, Gll^Fp, Gg, Gg, Gg, Ss, Gll^Fp, Gg, Gg, Gg
Gg, Rr, Rr, Rr, Gg, Gg, Gg, Gg, Gg, Gg, Gg, Gll^Fdf, Gll^Fdf, Gg, Rr, Gg, Gg, Gg, Gg, Gg, Gg, Gg, Gll^Fp, Gll^Fp, Gll, Gll, Gll, Gll, Gll, Gll, Ss^Bw/r, Kte, Ss^Bw\r, Gg, Gll^Fp, Gg, Gg, Gg, Gg, Gg, Gg, Gg, Gll^Fp, Gll^Fp, Gll^Fp, Rr, Gg, Gg, Gg, Gll^Fdf, Gll, Gll, Gg, Gg, Gll^Fp, Gll^Fp, Gll^Fp, Gll^Fp, Gll^Fp, Gll^Fp, Gg, Gg
Gg, Gg, Gg, Gg, Gg, Gg, Gll^Fp, Gg, Gg, Gg, Gg, Gll^Fdf, Gg, Gg, Gg^Vh, Rr, Rr, Gg, Gg, Gg, Gg, Gll^Fp, Gll^Fp, Gll^Fp, Ss, Ss, Ss, Gll, Gll, Gll, Gll^Fp, Ss^Bw|r, Gg^Vh, Rr, Gll^Fp, Gg, Gg, Gg, Gg, Gg, Gg, Gg, Gll^Fp, Gll^Fp, Rr, Rr, Gg, Gg, Gll^Fdf, Gll^Fdf, Gll, Gll^Fdf, Gll^Fdf, Gg, Gg, Gg, Gg, Gg^Ve, Gll^Fp, Gg^Ve, Gg, Gg
Gg, Gg, Gg, Gg, Hh, Hh, Gll^Fp, Gll^Fp, Gll^Fp, Gll^Fp, Gll^Fp, Gll^Fdf, Gll^Fdf, Gg, Gg, Gg, Gg, Rr, Rr, Gg, Gll^Fp, Gll^Fp, Gg^Ve, Gll^Fp, Gll^Fp, Ss, Ss, Ss, Gll^Fp, Gll, Gll^Fp, Gll^Fp, Gg, Rr, Gg, Gg, Gg, Gg, Gll^Fp, Gg, Gg, Gll^Fp, Gll^Fp, Gg, Rr, Gg, Gg, Gll^Fdf, Gll^Fdf, Gll^Fdf, Gll^Fdf, Gll^Fdf, Gll^Fdf, Gll^Fdf, Gll^Fdf, Gll^Fdf, Gg, Gg, Gll^Fp, Gll^Fp, Gg, Gg
Gll^Fdf, Gll^Fdf, Gll^Fdf, Hh, Hh, Gll^Fp, Gg, Gg, Gg, Gg^Ve, Gll^Fp, Gll^Fdf, Gg, Gg, Gg, Gg, Gg, Gg, Rr, Gg, Gg, Gll^Fp, Gg, Gg, Gg, Gll^Fp, Gll^Fp, Gll^Fp, Gll^Fp, Gll^Fp, Gll^Fp, Gg, Gg, Rr, Gg, Gg, Gg, Gg, Gg, Gg, Gg, Gg, Gg, Gg, Rr, Gg, Gg, Gll^Fdf, Gll^Fdf, Gll^Fdf, Gll^Fdf, Gll^Fdf, Gll^Fdf, Gll^Fdf, Gll^Fdf, Gll^Fdf, Gg, Gg, Gg, Gg, Gg, Gg
Gll^Fdf, Gll^Fdf, Gll^Fdf, Hh, Hh, Gll^Fp, Gg, Gg, Gg, Gg, Gll^Fp, Gg, Gg, Gg, Gg, Gg, Gg, Gg, Rr, Gg, Gg, Gg, Gg, Gg, Gg, Gg, Gg, Gg, Gll^Fp, Gll^Fp, Gg, Gg, Gg^Vh, Rr, Gg, Gg, Gg, Gg, Gg, Gg, Gg, Gg, Gg^Vh, Rr, Gg, Gg, Gg, Gg, Gg, Gg, Gg, Gll^Fdf, Gll^Fdf, Gll^Fdf, Gll^Fdf, Gll^Fdf, Gg, Gg, Gg, Gg, Gll^Fp, Gll^Fp
Gll^Fdf, Gll^Fdf, Gll^Fdf, Gg, Gg, Gll^Fp, Gg, Gg, Gg, Gg, Gg, Gg, Gg, Gg, Gg, Gg, Gg, Gg, Rr, Gg, Gg, Gg, Gll^Fp, Gll^Fp, Gg, Gg, Gg, Gg, Gg, Gg, Gg, Gg, Gg, Rr, Gg, Gll^Fdf, Gll^Fdf, Gg, Gg, Gg, Gg, Gg, Rr, Rr, Gg, Gg, Gg, Gg, Gg^Vh, Gg, Gll^Fdf, Gll^Fdf, Gll^Fdf, Gll^Fdf, Gll^Fdf, Gll^Fdf, Gll^Fdf, Gg, Gg, Gg, Gll^Fp, Gll^Fp
Gg, Gll^Fdf, Gll^Fdf, Gg, Gg, Gll^Fp, Gg, Gg, Gg, Gg, Gg, Gg, Gg, Gg, Gg, Gg, Gg, Gg, Rr, Gg, Gg, Hh, Hh, Mm, Hh, Gg, Gg, Gll^Fdf, Gll^Fdf, Gll^Fdf, Gll^Fdf, Gll^Fdf, Gg, Rr, Gg, Gg, Gll^Fdf, Gg, Gg, Gg, Rr, Rr, Gg, Gg, Gg, Gll^Fp, Gll^Fp, Gll^Fp, Gg, Gg, Gg, Gg, Gll^Fdf, Gll^Fdf, Gll^Fdf, Gll^Fdf, Gll^Fdf, Gg, Gg, Gg, Gll^Fp, Gll^Fp
Gg, Gll^Fdf, Gll^Fdf, Gll^Fdf, Gg, Gll^Fp, Gg, Gg, Gg, Gll^Fp, Gll^Fp, Gg, Gg, Gg, Gg, Gg, Gg, Gg, Rr, Gg^Vh, Gg, Hh, Mm, Hh, Gll^Fdf, Gll^Fdf, Gll^Fdf, Gll^Fdf, Gll^Fdf, Gll^Fdf, Gll^Fdf, Gg, Rr, Rr, Gg, Gg, Gg, Gg, Gg, Gg^Vh, Rr, Gg^Vh, Gg, Gg, Gll^Fp, Gll^Fp, Gll^Fp, Gll^Fp, Hh, Gll^Fp, Gll^Fp, Gg, Gg, Gg, Gll^Fdf, Gll^Fdf, Gll^Fdf, Gg, Gg, Gg, Gg, Gg
Gg, Gg, Gll^Fdf, Gg, Gg, Gg, Gll^Fp, Gg, Gg, Gll^Fp, Gll^Fp, Gg, Gg^Vh, Gg, Gg, Gg, Gg, Gg, Gg, Rr, Gg, Hh, Hh, Gll^Fdf, Gll^Fdf, Gll^Fdf, Gll^Fdf, Gll^Fdf, Gll^Fdf, Gll^Fdf, Gg, Rr, Gg, Gg, Gll^Fp, Gll^Fp, Gg, Gg, Rr, Rr, Gg, Gg, Gg, Gg, Gg, Gll^Fp, Gll^Fp, Hh, Hh, Hh, Hh, Gg, Gll^Fp, Gg, Gll, Gll^Fdf, Gll^Fdf, Gg, Gg, Gg, Gg, Gg
Gg, Gg, Gg, Gg, Gg, Gg, Gg, Gll^Fp, Gll^Fp, Gg^Ve, Gll^Fp, Gg, Gg, Gg, Gg, Gg, Gg, Gg, Gg, Rr, Gg, Gg, Gg, Gg, Gg, Gg, Gg, Gll^Fdf, Gll^Fdf, Gg, Rr, Rr, Gg, Gg, Gll^Fp, Gll^Fp, Gg, Gg, Rr, Gg, Gg, Gg, Gg, Gg, Gg, Gg, Hh, Hh, Hh, Hh, Hh, Gg, Gg, Gg^Vh, Gg, Gll^Fdf, Gll^Fdf, Gll^Fdf, Gg, Gg, Gll^Fp, Gll^Fp
Gll, Gll, Gll, Gg, Gg, Gg, Gg, Gg, Gll^Fp, Gll^Fp, Gll^Fp, Gg, Gg, Gg, Gg, Gg, Gg, Gg, Gg, Rr, Rr, Gg, Gg, Gg, Gg, Gg, Gg, Gg, Rr, Rr, Gg, Gg, Gg, Gll^Fp, Gll^Fp, Gg^Ve, Rr, Rr, Gg, Gg, Gg, Gg, Gg, Gll^Fdf, Gll^Fdf, Hh, Hh, Mm, Hh, Hh, Hh, Gg, Gg, Gll^Fp, Gg, Gll^Fdf, Gll^Fdf, Gll^Fdf, Gg, Gg, Gll^Fp, Gll^Fp
Gll, Gll, Gg, Gg^Vh, Gg, Gg, Gg, Gg, Gg, Gg, Gll^Fp, Gg, Gg, Gg, Gg, Gg, Gg, Gg, Gg, Gg, Gg, Rr, Rr, Gll^Fp, Gg^Ve, Gg, Gg, Gg, Rr, Gg^Vh, Gg, Gg, Gg, Gll^Fp, Rr, Rr, Gg, Gll^Fdf, Gll^Fdf, Gll^Fdf, Gll^Fdf, Gll^Fdf, Gll^Fdf, Gll^Fdf, Gll^Fdf, Gll^Fdf, Hh, Gg, Gll^Fp, Gll^Fp, Gg, Gg, Gll^Fp, Gg, Gg, Gll^Fdf, Gll^Fdf, Gll^Fdf, Gg, Gll^Fp, Gll^Fp, Gll^Fp
Gll^Fdf, Gll^Fdf, Gll^Fdf, Gg, Gll^Fdf, Gg, Gg, Gg, Gg, Gll^Fp, Gg, Gg, Gg, Gg, Gg, Gg, Gg, Gg, Gg, Gg, Gg, Gg^Vh, Rr, Gll^Fp, Gll^Fp, Gg, Gg, Gg, Rr, Cer, Cer, Gg, Rr, Rr, Gg, Gll^Fdf, Gll^Fdf, Gll^Fdf, Gll^Fdf, Gll^Fdf, Gll^Fdf, Gg, Gll^Fdf, Gll^Fdf, Gll^Fdf, Gll^Fdf, Gg, Gg, Gg^Vh, Gg, Gll^Fp, Gll^Fp, Gg, Gg, Gll^Fdf, Gll^Fdf, Gll^Fdf, Gll^Fdf, Gg, Gg, Gll^Fp, Gll^Fp
Gll^Fdf, Gll^Fdf, Gll^Fdf, Gll^Fdf, Gll^Fdf, Gg, Gg, Gg, Gg, Gg, Gg, Gg, Gg, Gg, Gg, Gg, Gll^Fdf, Gg, Gll^Fdf, Gg, Gg, Gg, Rr, Gg, Gg, Gg, Gg, Gll^Fdf, Gll^Fdf, Cer, Ker, Cer, Cer, Gg, Gg, Gll^Fdf, Gll^Fdf, Gll^Fdf, Gll^Fdf, Gll^Fdf, Gg, Gg, Gg, Gll^Fdf, Gg, Gg, Gg, Gg, Gg, Gg, Gg, Gg, Gg^Vh, Gg, Gg, Gll^Fdf, Gll^Fdf, Gll^Fdf, Gg, Gg, Gg, Gg
Gg, Gg, Gg, Gll^Fdf, Gll^Fdf, Gg, Gg, Gg, Gg, Gg, Gg, Gg, Gg^Ve, Gll^Fp, Gg, Gg, Gll^Fdf, Gll^Fdf, Gll^Fdf, Gg, Gg, Gg, Rr, Gg, Rr, Rr, Rr, Gll^Fdf, Gll^Fdf, Gll^Fdf, Gll^Fdf, Cer, Gg, Gg, Gll^Fdf, Gll^Fdf, Gll^Fdf, Gll^Fdf, Gll^Fdf, Gll^Fdf, Gg, Gg, Gg, Gg, Gg, Gg, Gg, Gg, Gg, Gg, Gg, Gg, Gg, Gg, Gg, Gg, Gg, Gg, Gg, Gg, Gll, Gll
Gg, Gg, Gg, Gll^Fdf, Gll^Fdf, Gg, Gg, Gg, Gg, Gg, Gg, Gg, Gll^Fp, Gll^Fp, Gg, Gg, Gll^Fdf, Gll^Fdf, Gll^Fdf, Gg, Gg, Gg, Gg, Rr, Rr, Gll^Fp, Rr, Gll^Fdf, Gll^Fdf, Gll^Fdf, Gll^Fdf, Gll^Fdf, Gll^Fdf, Gll^Fdf, Gll^Fdf, Gg, Gll^Fdf, Gll^Fdf, Gg, Gg, Gg, Gg^Vh, Gg, Gg, Gg, Gg, Gg, Gg, Gg, Gg, Gg, Gg, Gg, Gg, Gg, Gg, Gg, Gg, Gg, Gg, Gll, Gg
Gg, Gg, Gg, Gg, Gg, Gg, Gg, Gg, Gg, Gg, Gg, Gg, Gg, Gg, Gg, Gg, Gll^Fdf, Gll^Fdf, Gll^Fdf, Gg, Gg, Gg, Gg, Rr, Gll^Fdf, Rr, Gg, Gg, Rr, Rr, Rr, Gg, Gg, Gg, Gg, Gg, Gg, Gg, Gg, Gg, Gg, Gg, Gg, Gg, Gg, Gg, Gg, Gg, Gg, Gg, Gg, Gg, Gll^Fp, Gg, Gg, Gg, Gg, Gg, Gg, Gg, Gll, Gll
Gll, Gg, Gll^Fp, Gg, Gg, Gg^Vh, Gg, Gg, Gg, Gg, Gg, Gg, Gg, Gg, Gg, Gll^Fdf, Gll^Fdf, Gll^Fdf, Gll^Fdf, Gg, Gg, Gg, Gg, Rr, Gll^Fdf, Gg, Rr, Rr, Gll^Fp, Gg, Rr, Gg, Gg, Gll^Fp, Gg, Gg^Vh, Gg, Gg, Gg, Gg, Gg, Gg, Gg, Gg, Gg, Gg, Gll, Gg, Gg, Gg, Gll^Fp, Gll^Fp, Gll^Fp, Gll^Fp, Gll^Fp, Gll^Fp, Gll^Fp, Gll^Fp, Gll^Fp, Gg, Gg, Gll^Fp
Gll, Gg, Gg, Gg, Gll, Gg, Gg, Gg, Gg, Gll^Fdf, Gll^Fdf, Gll^Fdf, Gll^Fdf, Gll^Fdf, Gll^Fdf, Gll^Fdf, Gll^Fdf, Gll^Fdf, Gll^Fdf, Gg, Gg, Gg, Gg, Rr, Gll^Fdf, Rr, Gll^Fp, Gll^Fp, Gg^Ve, Gll^Fp, Gg, Rr, Gg, Gg, Gll^Fp, Gg, Gg, Gg, Gg, Gg, Hh, Gg, Gg, Gg, Gg, Gll, Ww, Gll, Gg, Gg, Gll^Fp, Gll^Fp, Gll^Fp, Gll^Fp, Gg, Gg, Gll^Fp, Gll^Fp, Gll^Fp, Gll^Fp, Gll^Fp, Gg
Gg, Gg, Gg, Gg, Gg, Gg, Gg, Gg, Gg, Gll^Fdf, Gll^Fdf, Gll^Fdf, Gll^Fdf, Gll^Fdf, Gll^Fdf, Gll^Fdf, Gll^Fdf, Gll^Fdf, Gll^Fdf, Gg, Gll^Fdf, Gll^Fdf, Gg, Gll^Fdf, Gll^Fdf, Rr, Gll^Fp, Gg^Ve, Gll^Fp, Gll^Fp, Gg, Rr, Gg, Gg, Gg, Gg, Gg, Gg, Gg, Hh, Gg, Gg, Gg, Gg, Gll, Gll, Ww, Gll, Gg, Gg, Gg, Gg^Ve, Gll^Fp, Gg, Gg, Gg, Gll^Fp, Gll^Fp, Gll^Fp, Gll^Fp, Gll^Fp, Gll^Fp
Gg, Gg, Gg, Gg, Gg, Gg, Gg, Gg, Gg, Gll^Fdf, Gll^Fdf, Gll^Fdf, Gll^Fdf, Gll^Fdf, Gll^Fdf, Gll^Fdf, Gg, Gg, Gg, Gg, Gll^Fdf, Gll^Fdf, Gll^Fdf, Gll^Fdf, Gll^Fdf, Rr, Gg, Gll^Fp, Gll^Fp, Gll, Gll, Rr, Gg, Gg, Gg, Gg, Gg, Gg, Hh, Gg, Gg, Gg, Gg, Gg, Gll, Gll, Ww, Gll, Gll, Gg, Gg, Gg, Gg, Gg, Gg, Gg, Gg, Gll^Fp, Gll^Fp, Gll^Fp, Gll^Fp, Gll^Fp
Gg, Gg, Gg, Gg, Gg, Gg, Gg, Gg, Gll^Fdf, Gll^Fdf, Gll^Fdf, Gll^Fdf, Gll^Fdf, Gll^Fdf, Gll^Fdf, Gll^Fdf, Gg, Gg, Gg^Vh, Gg, Gg, Gg, Gg, Gg, Gll^Fdf, Gll^Fdf, Rr, Gg, Ww, Ww, Gll, Rr, Rr, Gg, Gg, Gg, Gg, Gg, Gg, Gg, Gg^Vh, Gg, Gg, Gg, Wo, Ww, Gll, Gll, Gll, Gll, Gg, Gg, Gg, Gg^Vh, Gg, Gg, Gg, Gg, Gll^Fp, Gll^Fp, Gg^Ve, Gll^Fp
Gg, Gg, Gg, Gg, Gg, Gg, Gg, Gll^Fdf, Gll^Fdf, Gll^Fdf, Gll^Fdf, Gll^Fdf, Gll^Fdf, Gg, Gg, Gg, Gg, Gg, Gg, Gg, Gg, Gg, Gg, Gg, Gg, Gll^Fdf, Gll^Fdf, Gll, Ww, Wo, Ww, Gll, Gg, Rr, Rr, Gg, Gg, Gg, Gg, Gg, Gg, Gg, Gg, Gll, Wo, Ww, Ww, Ww, Ww, Gll, Gg, Gg, Gg, Gg, Gg, Gll^Fdf, Gg, Gg, Gg, Gg, Gll^Fp, Gll^Fp
Gg, Gg, Gg, Gg, Gg, Gg, Gg, Gll^Fdf, Gg, Gg, Gll^Fdf, Gg, Gg, Gg, Gg, Gg, Gg, Gll^Fdf, Gg, Gg, Gg, Gg, Gg, Gg, Rr, Rr, Gll^Fdf, Gll^Fdf, Gll, Gll, Gll, Gll^Fp, Gll^Fp, Gg, Gg^Vh, Rr, Gg, Gg, Gg, Gg, Gg, Gg, Gg, Gg, Gll, Wo, Ww, Ww, Ww, Gg, Gg, Gg, Gg, Gg, Gg, Gll^Fdf, Gg, Gg, Gg, Gg, Gg, Gg
Gg, Gg, Gg, Gg, Gg, Gg, Gg^Vh, Gg, Gg, Gg, Gg, Gg, Gg^Vh, Gg, Gg, Gg, Gg, Gll^Fdf, Cer, Gg, Gg, Gg, Gg, Rr, Gll, Gg, Gll^Fdf, Gll^Fdf, Rr, Gg, Gll, Gll^Fp, Gll^Fp, Gll^Fp, Gg, Rr, Rr, Gg, Gg, Gg, Gg, Gg, Gg, Gg, Gll, Wo, Ww, Gll, Gll, Gg, Gg, Gg, Gg, Gg, Gg, Gll^Fdf, Gll^Fdf, Gll^Fdf, Gg, Gg, Gg, Gg
Gg, Gg, Gg, Gg, Gg, Gg, Gg, Gg, Gg, Gg, Gg, Gg, Gll^Fp, Gll^Fp, Gg, Gg, Gg, Cer, Ker, Cer, Gg^Vh, Gg, Gg^Vh, Rr, Gg, Gll, Gll^Fdf, Gll^Fdf, Gll^Fdf, Rr, Gg, Gg, Gll^Fp, Gll^Fp, Gll^Fp, Gg, Gg, Rr, Gg, Gg, Gg, Gg, Gg, Gg, Gll, Gll, Gll, Gll, Gg, Gg, Gg, Gll^Fp, Gll^Fp, Gll^Fp, Hh, Gg, Gll^Fdf, Gg, Gg, Gg, Gg, Gg
Gg, Gg, Gg, Gg, Gg, Gg, Gg, Gg, Gg, Gg, Gg, Gg, Gll^Fp, Gll^Fp, Gg, Gg, Rr, Cer, Cer, Cer, Rr, Rr, Rr, Rr, Gg, Gg, Gll^Fdf, Gll^Fdf, Gll^Fdf, Rr, Rr, Gg, Gg, Gll^Fp, Gll^Fp, Gg, Gg, Rr, Rr, Gg, Gg, Gg, Gg, Gg, Gg, Gll, Gll, Gg, Gg, Gg, Gll^Fp, Gg^Ve, Gll^Fp, Gll^Fp, Gg, Gg, Gg, Gg, Gg, Gg, Gg, Gg
Gg, Gg, Gg, Gg, Gg, Gg, Gg, Gg, Gg, Gg, Gg, Gg, Gg, Gg, Rr, Rr, Gll^Fdf, Gll^Fdf, Gll^Fdf, Gll^Fdf, Gg, Gg, Gg, Gg, Gg, Gg, Gll^Fdf, Gll^Fdf, Gll^Fdf, Gg, Gg^Vh, Rr, Gg, Gg, Gg, Gg, Gg, Gg, Rr, Gg, Gg, Gg, Gg, Gg, Gg, Gg, Gg, Gll^Fdf, Gll^Fdf, Gg, Gg, Gll^Fp, Gll^Fp, Gll^Fp, Hh, Hh, Gg, Gg, Gg, Gg, Gg, Gll
Gg, Gg, Gg, Gg, Gg, Gg, Gg, Gg, Gg, Gg, Gg, Gg^Vh, Rr, Rr, Gg, Gg, Gg, Gll^Fdf, Gll^Fdf, Gll^Fdf, Gll^Fdf, Gg, Gg, Gg, Gg, Gll^Fdf, Gll^Fdf, Gll^Fdf, Gll^Fdf, Gll^Fdf, Rr, Rr, Gg, Gg, Gg, Gg, Gg, Gg, Gg, Rr, Gg, Gg, Gll^Fp, Gll^Fp, Gg, Gg, Gg, Gg, Gg, Gg, Gg, Gg, Gg, Hh, Hh, Hh, Hh, Gg, Gll^Fp, Gll^Fp, Gll, Gll
Gg, Gg, Gg, Gg, Gg, Gg, Gg, Gg, Rr, Rr, Gll^Fdf, Rr, Gg, Gll^Fp, Hh, Gg, Gg, Hh, Gg, Gg, Gll^Fdf, Gll^Fdf, Gg, Gg, Gg, Gll^Fdf, Gll^Fdf, Gll^Fdf, Gll^Fdf, Gll^Fdf, Gll^Fdf, Gll^Fdf, Gll^Fdf, Gll^Fdf, Gg, Gg, Gll^Fdf, Gll^Fdf, Gll^Fdf, Rr, Gg, Gg, Gll^Fp, Gll^Fp, Gll^Fp, Gll^Fp, Gll^Fp, Gg, Gg, Gg, Gg, Gg, Gg, Hh, Hh, Hh, Hh, Gg, Gll^Fp, Gll^Fp, Gll^Fp, Gll^Fp
Gg, Gg, Gg, Gg, Gg, Gg, 4 Gg^Vh, Rr, Gll^Fdf, Gll^Fdf, Gll^Fdf, Gll^Fdf, Gll^Fdf, Hh, Mm, Hh, Hh, Hh, Gg, Gg, Gll^Fdf, Gll^Fdf, Gll^Fdf, Gll^Fdf, Gll^Fdf, Gll^Fdf, Gll^Fdf, Gll^Fdf, Gg, Gll^Fdf, Rr, Gg, Gg, Gg, Gg, Gg, Gg, Gll^Fdf, Gll^Fdf, Gll^Fdf, Gg, Gg, Rr, Gll^Fp, Rr, Gll^Fp, Gll^Fp, Gg, Gg, Gg, Gg, Gg, Gg, Gg, Hh, Gg^Vh, Gg, Gg, Gll^Fp, Gll^Fp, Gll^Fp, Gll^Fp
Gll^Fp, Gll^Fp, Gll^Fp, Gll^Fp, Gll^Fp, Gg, Rr, Rr, Gll^Fdf, Gll^Fdf, Gll^Fdf, Gll^Fdf, Hh, Mm, Mm, Mm, Mm, Hh, Gg^Vh, Gg, Gll^Fdf, Gll^Fdf, Gll^Fdf, Gll^Fdf, Gll^Fdf, Gll^Fdf, Gll^Fdf, Gg, Gg, Rr, Gg, Gg, Gg, Gg, Gg, Gg, Gg, Gg, Gg, Rr, Rr, Rr, Gg, Rr, Gll^Fp, Rr, Gll^Fp, Gg, Gg, Gg, Gg, Gg, Gll^Fdf, Gll^Fdf, Gg, Gg, Gg, Gg, Gg, Gg, Gll^Fp, Gg
Gll^Fp, Gll^Fp, Gll^Fp, Gll^Fp, Gll^Fp, Gg, Rr, Gg, Gll^Fdf, Gll^Fdf, Gll^Fdf, Gll^Fdf, Hh, Hh, Mm, Mm, Mm, Hh, Gg, Gg, Gll^Fdf, Gll^Fdf, Gll^Fdf, Gll^Fdf, Gll^Fdf, Gll^Fdf, Gll^Fdf, Gg, Gg^Vh, Rr, Rr, Gll^Fp, Gll^Fp, Gll^Fp, Gll^Fp, Gll^Fp, Gg, Gg, Gg, Gg, Gg, Gll^Fp, Gll^Fp, Gll^Fp, Gll^Fp, Rr, Rr, Gll^Fp, Gg, Gg, Gg, Gg, Gll^Fdf, Gll^Fdf, Gg, Gg, Gg, Gg, Gg, Gg, Gg, Gg
Ss, Gll^Fp, Gll^Fp, Gll^Fp, Gg, Gg, Rr, Gg, Gll^Fdf, Gll^Fdf, Gll^Fdf, Gll^Fdf, Gg, Gg, Hh, Hh, Gg, Gg, Gg, Gg, Gll^Fdf, Gll^Fdf, Gll^Fdf, Gll^Fdf, Gll^Fdf, Gll^Fdf, Gll^Fdf, Gg, Gg, Gll^Fp, Gll^Fp, Rr, Gg, Gll^Fp, Gll^Fp, Gg^Ve, Gg, Gg, Gg, Gll^Fp, Gll^Fp, Gll^Fp, Gll^Fp, Gg^Ve, Gll^Fp, Gll^Fp, Rr, Gg, Gg, Gg, Gg, Gg, Gg, Gg, Gg, Gg, Gg, Gg, Gg, Gg, Gg, Gg
Gll^Fp, Gll^Fp, Gll^Fp, Gll^Fp, Gg, Rr, Gll^Fdf, Gll^Fdf, Gll^Fdf, Gll^Fdf, Gll^Fdf, Gll^Fdf, Gg, Gg^Vh, Gg, Gg, Gg, Gg, Gg, Gll^Fdf, Gll^Fdf, Gll^Fdf, Gll^Fdf, Gll^Fdf, Gg, Gg, Gg, Gg, Gg, Gll^Fp, Rr, Rr, Gg, Gg, Gll^Fp, Gll^Fp, Gg, Gg, Gg, Gg, Gll^Fp, Gll^Fp, Gll^Fp, Gll^Fp, Gg, Gg, Rr, Gg^Vh, Gg, Gg, Gg, Gg, Gg, Gg, Gg, Gll^Fp, Gll^Fp, Gg, Gg, Gg, Gg, Gg
Ss, Gll^Fp, Gll^Fp, Gg, Gg, Rr, Gll^Fdf, Gll^Fdf, Gll^Fdf, Gll^Fdf, Gll^Fdf, Gll^Fdf, Gg, Gg, Gg, Gg, Gll^Fdf, Gll^Fdf, Gll^Fdf, Gll^Fdf, Gll^Fdf, Gll^Fdf, Gll^Fdf, Gll^Fdf, Gg, Gg, Gg, Gg, Gg, Gg, Gg, Gll^Fp, Gg, Gg, Gll^Fp, Gll^Fp, Gg, Gg, Gg, Gll^Fp, Gll^Fp, Ss, Gll, Gll, Gll, Gll, Gll^Fdf, Rr, Rr, Gg, Gg, Gg, Gg, Gg, Gll^Fp, Gll^Fp, Gg, Gg, Gg, Gg, Gll^Fdf, Gll^Fdf
Gll^Fp, Gll^Fp, Ce, Gg, Rr, Rr, Gll^Fdf, Gll^Fdf, Gll^Fdf, Gll^Fdf, Gll^Fdf, Gll^Fdf, Gg, Gg, Gg, Gll^Fdf, Gll^Fdf, Gll^Fdf, Gll^Fdf, Gll^Fdf, Gll^Fdf, Gll^Fdf, Gll^Fdf, Gll^Fdf, Gg, Gg, Gg, Gg, Gg, Gg, Gg, Gll^Fp, Gll^Fp, Gll^Fp, Gll^Fp, Gg, Gg, Gg, Gg, Gg, Gll^Fp, Gll^Fp, Gll, Ww, Wo, Ww, Gll, Gll, Rr, Gll^Fp, Gll^Fp, Gll^Fp, Gll^Fp, Gll^Fp, Gg^Ve, Gll^Fp, Gg, Gg, Gg, Gll^Fdf, Gll^Fdf, Gll^Fdf
Gg, Gg, 2 Ke, Ce, Gg, Gll^Fdf, Gll^Fdf, Gll^Fdf, Gg, Gll^Fdf, Gll^Fdf, Gll^Fdf, Gll^Fdf, Gll^Fdf, Gll^Fdf, Gll^Fdf, Gll^Fdf, Gll^Fdf, Gll^Fdf, Gll^Fdf, Gll^Fdf, Gll^Fdf, Gll^Fdf, Gll^Fdf, Gll^Fdf, Gg, Gg^Vh, Gll^Fp, Gg, Gg, Gg, Gg, Gll^Fp, Gg^Ve, Gll^Fp, Gg, Gg, Gg, Gg, Gg, Gg, Gg, Gll, Gll, Wo, Wo, Gll, Gg, Rr, Gll^Fp, Gll^Fp, Gll^Fp, Gll^Fp, Gll^Fp, Gll^Fp, Gg, Gg, Gg, Gg, Gll^Fdf, Gll^Fdf, Gll^Fdf
Gg, Gg, Ce, Ce, Ce, Gg, Gg, Gg, Gll, Gll, Gll, Gll, Gll^Fdf, Gll^Fdf, Gll^Fdf, Ww, Gll, Gll^Fdf, Gll^Fdf, Gg, Gg, Gll^Fdf, Gll^Fdf, Gll^Fdf, Gll^Fdf, Gll^Fdf, Gg, Gg, Gg, Gll^Fdf, Gg, Gg, Gll, Gll^Fp, Gll^Fp, Gg^Vh, Gg, Gll^Fdf, Gll^Fdf, Gll^Fdf, Gg, Gg, Gg, Gll^Fdf, Gll, Gll, Gg, Gg, Gg, Rr, Rr, Gll^Fp, Gll^Fp, Gg, Gg, Gg, Gg, Gg, Gg, Gll^Fdf, Gll^Fdf, Gg
Gg, Gll^Fp, Gg, Ce, 1 Ke, Ce, Gg^Vh, Gg, Gll, Gll, Gll^Fp, Gll, Gll, Gll, Gll, Wo, Ww, Gll, Gll^Fdf, Gll^Fdf, Gg^Vh, Gg, Gll^Fdf, Gll^Fdf, Gll^Fdf, Gll^Fdf, Gll^Fdf, Gll^Fdf, Gll^Fdf, Gll^Fdf, Gg, Gg, Gll, Gll^Fp, Gll^Fp, Gg, Gg, Gll^Fdf, Gll^Fdf, Gll^Fdf, Gll^Fdf, Gll^Fdf, Gll^Fdf, Gll^Fdf, Gll, Gll, Gg^Vh, Gg, Gg, Gll^Fp, Gg^Ve, Rr, Rr, Gg, Gg, Gg, Gg, Gg, Gg, Gg, Gg, Gg
Gg, Gg, Gll^Fp, Gg, Gg, Ce, Ce, Ce, Ce, Gll, Gll, Gll^Fp, Gll, Gll, Ww, Ww, Ww, Gll, Gll^Fdf, Gg, Gg, Gg, Gg, Gg, Gg, Gll^Fdf, Gll^Fdf, Gll^Fdf, Gll^Fdf, Gll^Fdf, Gg, Gg, Gll^Fp, Gll^Fp, Gll^Fp, Gg, Gg, Gll^Fdf, Gll^Fdf, Gll^Fdf, Gll^Fdf, Gll^Fdf, Gll^Fdf, Gll^Fdf, Gll^Fdf, Gll, Gg, Gg, Gg, Gll^Fp, Gll^Fp, Gll^Fp, Gll^Fp, Gll^Fp, Gg, Gg, Gll^Fdf, Gll^Fdf, Gg, Gg, Gg, Gg
Gg, Gll^Fp, Gg^Ve, Gll^Fp, Gg, Gg, Gg, 3 Ke, Ce, Gll, Gll^Fp, Gll, Gll, Gll, Gll, Ww, Gll, Gll, Gll, Gll, Gll, Gll, Gg, Gg, Gg, Gll^Fdf, Gll^Fdf, Gll^Fdf, Gll^Fdf, Gll^Fdf, Gll^Fdf, Gll, Gg, Gg, Gg, Gg, Gg, Gll^Fdf, Gll^Fdf, Gll^Fdf, Gll^Fdf, Gll^Fdf, Gll^Fdf, Gll^Fdf, Gll^Fdf, Gll^Fdf, Gg, Gg, Gg, Gg, Gg, Gg, Gg, Gg, Gg, Gg, Gll^Fdf, Gll^Fdf, Gg, Gg, Gg, Gg
Gll^Fp, Gll^Fp, Gg, Gll^Fp, Gll^Fp, Gll^Fp, Gll^Fp, Gll, Gll, Gll, Gll, Gll^Fp, Gll, Gll, Gll, Gll, Ww, Ww, Gll, Gll, Gll, Gll, Gg, Gg, Gg, Gg, Gll^Fdf, Gll^Fdf, Gll^Fdf, Gll^Fdf, Gg, Gg, Gg, Gg, Gg, Gg, Gg, Gll^Fdf, Gll^Fdf, Gll^Fdf, Gll^Vh, Gll^Fdf, Gll^Fdf, Gll^Fdf, Gll^Fdf, Gll^Fdf, Gg, Gg, Gg, Gg, Gg, Gg, Gg, Gg, Gll^Fdf, Gg, Gg, Gg, Gg^Vh, Gg, Gll^Fdf, Gg
Gll^Fp, Gll^Fp, Gg, Gg, Ss, Gll, Gll^Fp, Gg, Gg, Gg, Gg, Gg, Gg, Gg, Gg, Gll, Gll, Ww, Gll, Ww, Ww, Ww, Gll, Gg, Gg, Gg, Gg, Gg, Gg, Gg, Gg^Vh, Gg, Gg, Gg, Gg, Gg, Gg, Gg, Gll^Fdf, Gg, Gll^Fdf, Gll^Fdf, Gll^Fdf, Gll^Fdf, Gll^Fdf, Gll^Fdf, Gg, Gg, Gg, Gg, Gg, Gg, Gg, Gg, Gg, Gg, Gg, Gg, Gg, Gg, Gg, Gg
Gg, Gll^Fp, Gll^Fp, Ss, Ss, Ss, Gll^Fp, Gg, Gg, Gg, Gg, Gg, Gg, Gg, Gg, Gll, Gll, Gll, Ww, Ww, Gll, Gll, Gg, Gg, Gg, Gg, Gg, Gg, Hh, Gg, Gg, Gll^Fp, Gll^Fp, Gg, Gg, Gg, Gg, Gll^Fdf, Gll^Fdf, Gll^Fdf, Gll^Fdf, Hh, Gll^Fdf, Gll^Fdf, Gll^Fdf, Gll^Fdf, Gg, Gg, Gg, Gg, Gg, Gg, Gg, Gg, Gg, Gg, Gll^Fp, Gg, Gg, Gg, Gg, Gg
