Aa, Aa, Aa, Aa, Aa, Aa, Aa, Rr, Aa, Aa, Aa, Aa, Aa, Aa, Aa, Aa, Aa, Aa, Rr, Aa, Aa, Aa, Aa, Ai, Aa^Vha, Ai, Ai, Aa, Ai, Ai, Rr, Ai, Ai, Ai, Aa^Vha, Ai, Ai, Ai, Ai, Aa^Fpa, Aa^Fpa, Ai
Aa, Aa, Aa, Aa, Aa, Aa, Aa, Rr, Aa, Aa, Aa, Aa, Aa, Aa, Aa, Aa, Aa, Aa, Aa, Aa, Aa, Ai, Ai, Ai, Ai, Ai, Ai, Ai, Ai, Aa^Vha, Rr, Ai, Aa^Fpa, Aa, Ai, Ai, Aa, Aa, Ai, Ai, Ai, Aa^Fpa
Rr, Aa, Aa, Aa, Aa, Aa, Aa, Aa, Aa, Aa, Aa, Ha, Ha, Aa, Aa, Aa, Aa, Aa, Aa, Rr, Aa^Vha, Ai, Ai, Aa, Ai, Ai, Ai, Ai, Ai, Ai, Ch, Rr, Aa, Aa, Cha, Cha, Cha, Aa, Aa, Ai, Ai, Ai
Rr, Aa, Aa, Aa, Aa, Aa, Aa, Aa, Ha, Ha, Ha, Ha, Ha, Ha, Aa, Aa, Aa, Aa, Aa, Rr, Aa^Fpa, Aa, Ai, Ai, Aa, Ai, Aa, Aa, Ai, Aa, Aa, Aa, Rr, Aa, Cha, 5 Kha, Cha, Aa, Ai, Ai, Ai, Aa
Rr, Aa, Aa, Aa, Aa, Aa^Vha, Aa, Aa, Ha, Ha, Ha, Ha, Ha, Ha, Ha, Ha, Aa, Aa, Rr, Aa^Vea, Aa^Fpa, Aa^Fpa, Aa, Ai, Ai, Aa^Vha, Ai, Aa, Aa, Ai, Ai, Ai, Rr, Rr, Aa, Cha, Aa, Ai, Ai, Aa, Ai, Ai
Rr, Rr, Rr, Rr, Rr, Rr, Aa, Aa, Ha, Ha, Ha, Ha, Ha, Ha, Ha, Ha, Aa, Aa^Fpa, Rr, Aa^Fpa, Aa^Fpa, Aa^Fpa, Aa, Ai, Ai, Ai, Ai, Ai, Ai, Ai, Ai, Ai, Ai, Aa, Rr, Aa, Aa^Vha, Ai, Aa, Ai, Ai, Aa
Aa^Fpa, Aa^Fpa, Aa^Fpa, Aa, Rr, Rr, Rr, Rr, Ha, Rr, Rr, Rr, Ha, Ha, Ha, Ha, Ha, Ha, Rr, Rr, Aa^Fpa, Aa^Fpa, Aa^Fpa, Ai, Ai, Aa, Ai, Aa, Ai, Ai, Ai, Aa^Vha, Aa, Aa, Rr, Aa, Aa, Ai, Ai, Aa^Fpa, Aa, Aa
Aa^Fpa, Aa^Fpa, Aa^Fpa, Aa, Aa, Rr, Aa, Ha, Rr, Ha, Ha, Cha, Rr, Rr, Ha, Ha^Vhha, Ha, Ha, Aa^Fpa, Aa^Fpa, Rr, Rr, Aa^Fpa, Ai, Ai, Ai, Ai, Ai, Aa, Aa, Ai, Ai, Aa, Aa, Rr, Aa, Aa, Aa, Ai, Aa^Vha, Aa, Aa
Aa^Fpa, Aa^Fpa, Aa^Fpa, Aa^Fpa, Ha, Rr, Aa^Vha, Ha, Ha, Ha, Ha, Cha, Cha, Cha, Rr, Rr, Ha, Ha, Aa^Fpa, Aa^Fpa, Aa^Fpa, Aa^Fpa, Rr, Rr, Rr, Rr, Aa, Ai, Ai, Ai, Aa, Aa, Ai, Ai, Rr, Aa, Ai, Ai, Ai, Ai, Aa, Aa
Aa^Fpa, Aa^Fpa, Ha, Ha, Ha, Ha, Rr, Rr, Ha, Ha, Ha, Cha, 6 Kha, Cha, Ha, Rr, Ha, Ha, Aa^Fpa, Aa^Fpa, Aa^Fpa, Aa, Aa, Aa, Aa, Ai, Ch, Ai, Aa, Ai, Aa, Aa, Ai, Ai^Bw/, Rr, Aa^Fpa, Ai, Ai, Ai, Aa, Aa, Ai
Aa^Fpa, Aa^Fpa, Ha, Ha, Ha, Ha, Ha, Ha, Rr, Rr, Ha, Ha, Cha, Ha, Ha, Ha, Rr, Rr, Aa^Fpa, Aa^Fpa, Aa^Fpa, Aa, Aa, Aa, Ai, Ai, Rr, Aa, Ai, Ai, Aa, Aa, Rr, Ai, Aa^Fpa, Ai, Ai, Aa, Ai, Aa, Aa, Ai
Rr, Ha, Ha, Ha, Ha, Ha, Ha, Ha, Ha, Ha, Rr, Rr, Aa, Aa, Aa, Aa, Aa, Rr, Aa, Aa, Aa, Aa, Aa, Ai, Aa^Vha, Ai, Rr, Aa, Aa, Ai, Ai, Ai, Rr, Aa, Ai, Ai, Aa, Ai, Ai, Ai, Aa, Ai
Rr, Ha, Ha, Ha, Ha, Ha, Ha, Ha, Ha, Ha, Ha, Aa^Vha, Rr, Rr, Aa, Aa, Aa, Aa, Rr, Aa, Aa, Ai, Ai, Aa, Ai, Ai, Rr, Aa, Ai, Ai, Ai, Ai, Ai^Bw|, Ai, Ai, Ai, Aa^Vha, Ai, Ai, Ai, Ai, Ai
Ha, Ha, Ha, Ms, Ha, Ms, Ms, Ha, Ha, Ha, Ha, Ha, Aa^Fpa, Aa, Rr, Aa, Aa, Aa^Vha, Rr, Ch, Ai, Ai, Aa, Aa, Ai, Ai, Rr, Ai, Ai, Ai, Ai, Ai, Aa, Aa, Aa, Ai, Ai, Aa, Aa, Aa, Ai, Ai
Ha, Ha, Ha, Ms, Ms, Ms, Ms, Ha, Ha, Ha, Ha, Ha, Ha, Aa^Fpa, Rr, Aa^Fpa, Aa^Fpa, Ai, Ai, Ai^Bw|, Ai, Ai, Ai, Ai, Aa, Aa, Rr, Ai^Bw\, Ai, Ai, Ai, Aa, Aa, Aa, Aa, Ai, Ai, Aa, Aa, Ai, Ai, Ai
Ha, Ms, Ms, Ms, Ms, Ms, Ms, Ha, Ha, Ha, Ha, Ha, Aa^Fpa, Aa, Rr, Rr, Aa, Ai, Ai, Ch, Ai, Aa, Aa, Ai, Aa^Fpa, Ai, Aa, Ai, Rr, Rr, Aa, Aa, Aa, Ai, Ai, Ai, Ai, Aa, Ai, Ai, Aa, Aa
Ms, Ms, Ms, Ms, Ms, Ms, Ms, Ms, Ha, Ha, Ha, Ha, Ha, Aa, Aa, Aa, Rr, Ai, Ai, Ai, Rr, Aa, Aa, Aa^Fpa, Ai, Ai, Ai, Ai, Aa^Fpa, Aa, Rr, Rr, Rr, Ai, Aa, Aa, Ai, Ai, Aa, Ai, Ai, Ai
Ms, Ms, Ms, Ms, Ms, Ms, Ms, Ms, Ha, Ha^Vhha, Ha, Ha, Ha, Aa, Aa, Aa, Rr, Aa^Fpa, Aa, Aa, Rr, Rr, Aa^Fpa, Aa^Fpa, Aa^Fpa, Aa^Fpa, Aa^Fpa, Aa^Fpa, Aa^Fpa, Aa^Fpa, Aa^Vha, Ai, Ai^Bw\, Rr, Aa, Aa, Aa, Aa, Ai, Ai, Ai, Aa
Ms, Ms, Ms, Ms, Ms, Ms, Ms, Ms, Ha, Ha, Ha, Ha, Ha, Aa^Fpa, Aa, Aa^Fpa, Rr, Rr, Aa, Aa, Aa, Cha, Rr, Rr, Aa^Fpa, Aa^Fpa, Aa^Fpa, Aa^Fpa, Aa^Fpa, Aa^Fpa, Aa^Fpa, Ai, Rr, Rr, Rr, Aa, Rr, Aa^Vha, Aa, Ai, Ai, Ai
Ms, Ms, Ms, Ms, Ms, Ms, Ms, Ms, Ms, Ha, Ha, Ha, Ha, Aa^Vea, Aa^Fpa, Aa, Aa^Fpa, Aa, Rr, Aa, Cha, 7 Kha, Cha, Aa^Fpa, Rr, Rr, Aa^Fpa, Ai, Ai, Ai, Ai, Ai, Aa^Fpa, Rr, Aa, Aa, Rr, Rr, Ai, Ai, Ai, Ai
Ms, Ms, Ms, Ms, Ms, Ms, Ms, Ms, Ms, Ms, Ha, Ha, Ha, Aa^Fpa, Aa, Aa, Aa^Fpa, Aa^Fpa, Rr, Rr, Aa, Aa, Aa, Aa^Fpa, Aa^Fpa, Ai, Rr, Ai, Aa^Fpa, Ai, Aa^Fpa, Ai, Aa^Fpa, Rr, Aa, Aa, Aa, Rr, Ai, Ai, Ai, Rr
Ms, Ms, Ms, Ms, Ms, Ms, Ms, Ms, Ms, Ms, Ms, Ha, Ha, Ha, Aa, Aa, Aa^Fpa, Aa^Vea, Aa^Fpa, Rr, Aa, Aa, Aa, Aa, Aa^Vha, Ai, Ai^Bw|, Ai, Aa, Aa, Ai, Aa^Vha, Aa, Rr, Aa, Aa, Aa, Aa, Rr, Rr, Rr, Aa
Ms, Ms, Ms, Ms, Ms, Ms, Ms, Ms, Ms, Ms, Ms, Ha, Ha, Ha, Ha, Aa, Aa^Fpa, Aa^Fpa, Aa^Fpa, Rr, Aa, Aa, Aa, Ai, Ai, Ai, Rr, Ai, Ai, Ai, Ai, Ai, Ai, Rr, Aa, Aa, Aa, Rr, Rr, Rr, Aa, Aa^Fpa
Ms, Ms, Ms, Ms, Ms^Vhha, Ms, Ms, Ms, Ms, Ms, Ms, Ms, Ms, Ha, Ha, Ha, Aa^Fpa, Aa^Fpa, Aa^Fpa, Rr, Aa, Ai, Ai, Ai, Ai, Aa, Rr, Rr, Ai, Aa, Aa, Ai, Ai, Aa, Rr, Rr, Rr, Ai, Ai, Rr, Aa^Fpa, Aa^Fpa
Ms, Ms, Ms, Ms, Ms, Ms, Ms, Ms, Ms, Ms, Ms, Ms, Ms, Ms, Ha, Ha, Ha, Ha, Rrc, Rr, Ai, Ai, Aa, Ai, Ai, Ai, Aa^Fpa, Ch, Ai, Aa, Aa, Ai, Ai, Ai, Aa, Ai, Ai, Aa, Ai, Rr, Aa, Aa^Fpa
Ms, Ms, Ms, Ms, Ms, Ms, Ms, Ms, Ms, Ms, Ms, Ms, Ms, Ms, Ms, Ms, Rrc, Rrc, Ha^Vhha, Rr, Aa, Aa, Ai, Ai, Ai, Ai, Ai, Ai, Rr, Rr, Aa, Ai, Ai, Ai, Ai, Ai, Ai, Ai, Ai, Rr, Aa^Fpa, Aa^Fpa
Ha, Ms, Ms, Ms, Ms, Ms, Ms, Ms, Ms, Ms, Ms, Ms^Vhha, Ms, Ms, Ms, Ms, Rrc, Ha, Ha, Ha, Rr, Rr, Aa^Fpa, Ai, Ai, Ai, Aa^Fpa, Ai, Ai, Rr, Ai, Aa, Aa, Ai, Ai, Ai, Ai, Aa, Aa, Aa^Fpa, Rr, Rr
Ha, Ha, Ha, Ms, Ms, Ms, Ms, Ms, Ms, Ms, Cha, Ms, Rrc, Ms, Rrc, Rrc, Ms, Ms, Ha, Ha, Ha, Rr, Aa^Fpa, Aa^Fpa, Ai, Aa^Vea, Ai, Aa^Vea, Aa^Fpa, Rr, Ai, Ai, Ai, Ai, Aa^Vha, Aa, Aa, Ai, Ai, Ai, Ai, Ai
Ha, Ha, Ha, Ms, Ms, Ms, Ms, Ms, Ms, Cha, 4 Kha, Cha, Rrc, Rrc, Ms, Ms, Ms, Ms, Ms, Ha, Ha, Ha, Rr, Rr, Aa^Fpa, Aa^Fpa, Aa^Fpa, Aa^Fpa, Aa^Fpa, Aa^Fpa, Ch, Ai, Ai, Ai, Ai, Ai, Ai, Aa^Fpa, Ai, Aa^Fpa, Ai, Ai
Ha, Ha, Ha, Ha, Ha, Ms, Ms, Ms, Ms, Cha, Cha, Cha, Ms, Ms, Ms, Ms, Ms, Ms, Ms, Ha, Ha, Ha, Aa, Rr, Aa^Fpa, Aa^Fpa, Aa^Fpa, Aa^Fpa, Aa^Fpa, Aa^Fpa, Rr, Ai, Ai, Aa, Aa, Ai, Ai, Aa, Aa, Ai, Ai, Aa^Fpa
Ha, Ha, Ha, Ha, Ha, Ha, Ms, Ms, Ms, Ms, Ms, Ms, Ms, Ms, Ms, Ms, Ms, Ms, Ms, Ms, Ha, Ha, Ha, Ha, Rr, Rr, Aa^Fpa, Aa^Fpa, Aa^Fpa, Aa^Fpa, Rr, Aa^Fpa, Ai, Aa, Aa^Fpa, Ai, Ai, Ai, Ai, Ai, Ai, Aa^Fpa
Aa^Fpa, Aa^Fpa, Ha, Aa^Fpa, Ha, Ha, Ha, Ms, Ms, Ms, Ms, Ms, Ms, Ms, Ms, Ms, Ms, Ms, Ms, Ms, Ms, Ms, Ha, Ha, Ha, Aa^Vea, Rr, Rr, Aa^Fpa, Aa^Fpa, Rr, Aa^Fpa, Aa^Fpa, Aa^Fpa, Aa^Fpa, Aa^Fpa, Ai, Ai, Ai, Ai, Aa^Fpa, Ai
Aa, Aa^Fpa, Aa^Fpa, Aa^Fpa, Aa, Ha, Ha, Ha, Ms, Ms, Ms, Ms, Ms, Ms, Ms, Ms, Ms, Ms, Ms, Ms, Ms, Ms, Ms, Ha, Ha, Ha, Aa^Fpa, Aa, Rr, Aa^Fpa, Cha, Cha, Cha, Aa^Fpa, Aa^Fpa, Ai, Ai, Ai, Aa, Aa^Fpa, Aa^Fpa, Ai
Aa^Vha, Aa^Vha, Ai, Aa, Aa, Aa^Vha, Ha, Ha, Ha, Ha, Ms, Ms, Ms, Ms, Ms, Ms, Ms, Ms, Ms, Ms, Ms, Ms, Ms, Ms, Ha, Ha, Ha, Aa, Rr, Rr, Cha, 3 Kha, Aa^Fpa, Aa, Aa^Fpa, Aa^Fpa, Ai, Ai, Aa^Fpa, Ai, Ai, Ai
Ai, Ai, Ai, Aa, Aa, Aa, Aa, Ha, Ha, Ha, Ha, Ha^Vhha, Ha, Ha, Ms, Ms^Vhha, Ms, Ms, Ms, Ms, Ms, Ms, Ms, Ms, Ha, Ha, Ha, Ha, Ha, Ha^Vhha, Rr, Rr, Rr, Rr, Cha, Cha, Cha, Ai, Ai, Ai, Ai, Ai
Ai, Ai, Ai, Aa, Aa, Aa, Aa, Aa, Ha, Ha, Ha, Ha, Ha, Ha, Ms, Ha, Ms, Ms, Ms, Ms, Ms, Ms, Ms, Ms, Ms, Ha, Ha, Ha, Ha, Ha, Ha, Ha, Rr, Rr, Aa^Fpa, 2 Kha, Cha, Ai, Ai, Ai, Aa^Vha, Ai
Ai, Ai, Aa, Ai, Ai, Aa, Aa, Aa, Aa, Aa, Ha, Ha, Ha, Ha, Ha, Ha, Ms, Ms, Ms, Ms, Ms, Ms, Ms, Ms, Ms, Ms, Ms, Ms, Ms, Ms, Ms, Ha, Cha, Rr, Rr, Aa^Fpa, Rr, Rr, Ai, Ai, Ai, Rr
Ai, Aa, Ai, Ai, Ai, Aa, Aa, Aa, Aa, Aa, Aa^Fpa, Aa, Ha, Ha, Ha, Ha, Ha, Ms, Ms, Ms, Ms, Ms, Ms, Ms, Ms, Ms, Ms, Ms, Ms, Ms, Ms, Ms, Cha, 1 Kha, Cha, Rr, Aa^Fpa, Aa^Fpa, Rr, Rr, Rr, Aa
Ai, Aa, Ai, Ai, Ai, Ai, Aa, Aa, Aa, Aa, Aa, Aa, Ha, Ha, Ha, Ha, Ha, Ms, Ms, Ms, Ms, Ms^Vhha, Ms, Ms, Ms, Ms, Ms, Ms, Ms, Ms, Ms, Ms, Ms, Cha, Ha, Rr, Aa^Fpa, Aa^Fpa, Aa^Fpa, Aa, Aa, Aa
Ai, Aa^Vha, Aa^Fpa, Aa^Fpa, Aa^Vha, Ai, Aa, Ai, Aa, Aa, Aa, Aa, Aa, Ha, Ha, Ha, Ha, Ms, Ms, Ms, Ms, Ms, Ms, Ms, Ms, Ms, Ms, Ms, Ms, Ms, Ms, Ms, Ms, Ms, Ha, Ha, Rr, Rr, Aa, Aa, Aa^Fpa, Aa
Ai, Aa^Fpa, Aa^Fpa, Aa^Fpa, Aa, Aa, Ai, Aa, Ai, Aa, Aa, Aa, Aa, Ha, Ha, Ha, Ha, Ms, Ms, Ms, Ms, Ms, Ms, Ms, Ms, Ms, Ms, Ms, Ms, Ms, Ms, Ms, Ms, Ms, Ha, Ha, Ha, Aa, Rr, Rr, Aa, Aa
Ai, Aa^Fpa, Aa^Fpa, Aa^Fpa, Aa, Aa, Aa, Aa, Ai, Ai, Ai, Aa, Aa, Ha, Ha, Ha, Ms^Vhha, Ms, Ms, Ms, Ms, Ms, Ms, Ms, Ms, Ms, Ms, Ms^Vhha, Ms, Ms, Ms, Ms, Ms, Ms, Ms, Ha, Ha, Aa, Aa^Fpa, Aa^Fpa, Rr, Rr
