Gg, Gg^Fp, Gg^Fp, Gg^Fp, Gg^Fp, Gg^Fp, Gg^Fp, Gg, Gg, Gg, Gg, Gg, Rr, Gg, Rr, Rr, Gg^Fp, Gg^Fp, Gg^Fp, Rr, Rr, Gg, Rr, Gg, Rr, Rr, Gg, Gg, Gg, Rr, Gg, Gg^Fp, Gg^Fp, Gg, Hh, Hh, Ww, Ww
Gg, Gg^Fp, Gg^Fp, Gg^Fp, Gg^Fp, Gg^Fp, Gg^Fp, Gg, Rr, Rr, Rr, Rr, Gg^Vh, Rr, Gg, Gg, Gg^Fp, Gg^Ve, Gg^Fp, Gg, Gg, Rr, Gg, Rr, Gg, Gg, Gg, Gg, Gg, Gg, Gg, Gg^Fp, Gg, Gg, Gg, Gg^Fp, Ww, Ww
Gg, Gg, Gg^Fp, Gg, Rr, Rr, Rr, Rr, Gg^Fp, Gg, Gg, Gg, Gg, Gg, Gg, Gg, Gg, Gg^Fp, Gg^Fp, Gg^Fp, Gg^Fp, Gg, Gg, Gg, Gg^Fp, Gg, Gg, Gg, Gg, Gg, Gg, Gg^Fp, Gg^Fp, Gg^Fp, Gg, Gg^Fp, Gg^Ve, Ww
Ww, Ww, Ww, Ch, Ww, Ww, Gg, Gg, Gg, Gg, Gg, Gg, Gg, Gg, Gg, Gg, Gg, Gg, Gg, Gg^Fp, Gg^Fp, Gg^Fp, Gg^Fp, Gg^Fp, Gg^Fp, Gg, Gg, Gg, Gg, Wo, Gg, Gg, Gg^Fp, Gg^Ve, Gg^Fp, Gg^Fp, Gg^Fp, Gg^Fp
Gg, Gg, Rr, Rr, Gg, Wo, Wo, Wo, Wo, Wo, Wo, Gg, Gg, Gg, Gg, Gg, Gg, Gg, Gg, Gg, Gg^Fp, Gg^Fp, Gg^Ve, Gg^Fp, Gg^Fp, Gg, Gg, Gg, Gg, Wo, Gg, Gg, Gg, Gg^Fp, Gg^Fp, Gg^Fp, Gg^Fp, Gg^Fp
Rr, Rr, Gg, Gg, Gg, Wo, Wo, Wo, Wo, Gg, Gg, Gg, Gg, Gg, Gg, Gg, Gg, Gg, Gg, Gg, Gg^Fp, Gg^Fp, Gg^Fp, Gg^Fp, Gg, Gg, Gg, Gg, Gg, Wo, Gg, Gg, Gg, Gg, Gg, Gg, Gg^Fp, Gg^Fp
Gg, Gg, Gg, Gg, Gg, Wo, Wo, Wo, Wo, Gg, Gs^Vda, Gg, Gg, Gg, Gg, Gg, Gg, Rr, Rr, Gg, Gg^Fp, Gg^Fp, Gg, Gg^Fp, Gg^Fp, Gg, Gg, Gg, Gg, Gg, Gg, Gg, Gg, Gg, Gg, Gg, Gg, Gg
Gg, Gg, Gg, Gg, Gg, Wo, Wo, Wo, Gg, Gg, Gg, Gg, Gg, Gg, Gg, Gg, Gg, Gg, Gg, Rr, Rr, Rr, Rr, Ss, Gg^Fp, Gg, Gg, Gg, Gg, Gg, Gg, Gg, Gg, Gg, Gg, Gg, Gg, Gg
Wo, Gg, Gg, Gg, Gg, Gg, Gg, Gg, Gg, Gg^Fp, Gg, Gg, Gg, Gg, Gg, Gg, Gg^Fp, Gg^Fp, Gg^Ve, Gg^Fp, Gg^Fp, Ss, Gg^Fp, Rr, Rr, Gg, Gg, Gg, Gg, Gg, Gg, Gg, Gg, Gg, Gg, Gg, Gg, Gg
Gg, Gg, Gg^Fp, Ss, Ss, Ss, Gg, Gg, Ss, Gg, Gg, Gg, Gg, Gg^Fp, Gg, Gg^Fp, Hh, Gg^Fp, Gg^Fp, Gg^Fp, Gg^Fp, Gg^Fp, Gg^Fp, Gg^Fp, Gg, Rr, Rr, Gg, Gg, Gg, Gg, Gg^Fp, Gg^Fp, Gg, Gg, Gg, Gg, Rr
Ss, Ss, Ss, Ss, Ss, Gg, Gg, Gg, Gg^Fp, Gg, Gg, Gg, Gg^Fp, Gg^Ve, Gg, Gg^Fp, Hh, Hh, Gg, Gg, Gg^Fp, Gg, Gg, Gg, Gg, Gg, Gg, Rr, Gg, Gg, Gg, Gg^Fp, Gg^Fp, Gg^Fp, Gg, Gg^Fp, Gg^Fp, Rr
Ss, Gg^Fp, Gg^Fp, Gg^Fp, Gg^Fp, Gg, Gg, Gg, Gg^Fp, Gg, Gg, Gg, Gg, Gg^Fp, Gg, Gg^Fp, Gg^Fp, Gg, Gg, Gg, Gg^Fp, Gg, Gg, Gg, Gg, Gg, Gg, Rr, Rr, Gg, Gg, Gg, Gg^Fp, Gg^Fp, Gg^Fp, Gg^Fp, Gg^Fp, Rr
Ss, Gg^Fp, Gg^Ve, Gg^Fp, Gg^Fp, Gg^Ve, Gg^Fp, Gg^Fp, Gg, Gg, Gg, Gg, Gg, Gg, Gg, Gg, Hh, Hh, Hh, Hh, Gg^Fp, Gg, Gg, Gg, Gg, Gg, Gg, Gg^Fp, Gg, Rr, Rr, Gg, Gg, Gg^Fp, Gg^Ve, Gg^Fp, Rr, Rr
Gg^Fp, Gg^Fp, Gg^Fp, Gg^Fp, Gg, Gg, Gg, Gg, Gg, Gg, Gg, Gg, Gg, Gg, Gg, Hh, Mm, Mm, Mm, Hh, Gg^Ve, Gg, Gg^Vh, Gg, Gg, Gg, Gg, Gg, Gg, Gg, Gg, Rr, Gg, Gg^Fp, Gg^Fp, Rr, Gg, Gg^Fp
Gg^Fp, Gg^Fp, Gg, Gg, Gg, Gg, Gg, Gg, Gg, Gg, Gg, Gg, Gg, Gg, Gg, Hh, Mm, Mm, Cv, Ww, Ww, Ww, Gg, Gg, Gg, Wo, Gg, Gg, Gg, Gg, Gg, Rr, Rr, Gg, Rr, Rr, Gg, Gg^Fp
Gg, Gg, Gg, Gg, Gg, Gg, Gg, Gg, Gg, Gg, Gg, Gg, Gg, Gg, Gg, Mm, Mm, 1 Kv, 2 Kv, Cv, Ww, Ww, Gg, Gg, Gg, Wo, Gg, Gg, Gg, Gg, Gg, Gg, Rr, Gg, Rr, Gg^Fp, Gg^Fp, Gg^Fp
Gg, Gg, Gg, Gg, Gg, Gg, Gg, Gg, Gg, Gg, Gg, Gg, Gg, Gg, Gg, Mm, Mm, 3 Kv, Cv, Cv, Ww^Bw\, Ww, Ww, Ww, Gg, Ww, Gg, Gg^Fp, Gg^Fp, Gg^Fp, Gg, Gg, Gg, Rr, Rr, Gg^Fp, Gg^Ve, Gg^Fp
Gg, Gg, Gg, Gg, Gg, Gg, Gg^Vh, Gg, Gg, Gg, Gg, Gg, Gg, Gg, Gg, Mm, Mm, Mm, Ww, Ww, Ww, Gg^Fp, Gg^Fp, Ww, Ww, Ww, Gg, Gg^Fp, Ss, Gg^Fp, Gg, Gg, Rr, Rr, Rr, Gg^Fp, Gg^Fp, Gg^Fp
Wo, Gg, Gg, Gg, Gg, Gg, Gg, Gg, Gg, Gg, Gg, Gg, Gg, Gg, Gg, Gg, Mm, Mm, Mm, Ww, Ww, Gg^Fp, Ss, Ww, Ss, Ww, Gg, Gg^Fp, Gg^Fp, Gg^Fp, Gg, Gg, Rr, Gg^Vh, Rr, Gg, Gg, Hh
Wo, Gg, Gg, Gg, Gg, Gg, Gg, Gg^Fp, Gg^Fp, Gg^Fp, Gg, Gg, Gg, Gg, Gg, Gg, Mm, Mm, Hh, Hh, Gg^Fp, Gg, Ww, Ww, Ss, Gg^Fp, Gg, Gg, Gg, Gg^Fp, Gg^Fp, Gg^Fp, Rr, Gg, Rr, Gg^Fp, Hh, Hh
Wo, Wo, Gg, Gg, Gg, Gg, Gg^Fp, Gg^Fp, Gg^Fp, Ss, Ss, Gg^Fp, Gg^Vh, Gg, Gg, Gg, Gg, Hh, Hh, Gg, Gg^Fp, Gg, Ww, Gg, Gg, Gg, Gg, Gg, Gg, Gg^Fp, Gg^Fp, Gg, Rr, Gg, Rr, Hh, Gg^Fp, Gg^Fp
Wo, Wo, Gg, Gg, Gg, Gg, Gg^Fp, Ss, Ss, Ss, Gg, Gg^Fp, Gg^Fp, Gg, Gg, Gg, Gg, Gg, Gg, Gg, Gg^Fp, Gg, Ww, Gg, Gg, Gg^Fp, Gg, Gg, Gg, Gg, Gs, Gg, Rr, Gg, Rr, Gg, Gg^Fp, Gg^Fp
Wo, Wo, Gg, Gg, Gg, Gg^Fp, Gg^Fp, Ss, Ss, Ss, Ss, Gg^Fp, Gg, Gg^Fp, Gg, Gg, Gg, Gg, Gg, Gg, Gg^Fp, Ww, Ww, Ww, Gg^Vh, Gg, Gg^Fp, Gg^Fp, Gg^Fp, Gg^Fp, Gg, Gg, Rr, Gg, Rr, Gg^Fp, Gg^Fp, Gg
Wo, Wo, Gg, Gg, Gg, Gg^Fp, Ss, Ss, Gg^Ve, Gg^Fp, Gg, Gg, Gg, Gg, Gg^Fp, Gg, Gg, Gg, Gg, Gg, Gg, Ww, Ww, Ww, Gg, Gg, Gg, Gg, Gg^Fp, Gg^Ve, Gg, Gg, Rr, Rr, Gg, Gg^Fp, Gg^Fp, Gg^Fp
Wo, Wo, Gg, Gg, Gg, Gg^Fp, Ss, Gg^Fp, Gg^Fp, Gg, Gg, Gg^Vh, Gg, Gg, Gg, Gg, Gg, Gg, Gg, Gg, Gg, Gg^Fp, Gg^Fp, Ww, Ww, Gg, Gs, Gg, Ss, Gg^Fp, Gg, Gg, Rr, Rr, Rr, Gg^Fp, Gg^Fp, Gg^Fp
Wo, Wo, Gg, Gg, Gg, Gg, Gg^Fp, Gg, Gg, Gg^Fp, Gg, Gg, Gg, Gg, Gg, Gg, Gg, Gg, Gg, Gg^Vh, Gg, Gg, Gg, Ww, Ww, Gg, Gg, Gg, Gg^Fp, Gg, Gg, Gg, Rr, Gg, Rr, Gg^Fp, Gg^Fp, Gg^Fp
Gg, Gg, Gg, Gg^Vh, Gg, Gg, Gg^Fp, Gg, Gg, Gg, Gg^Fp, Gg, Gg, Gg, Gg, Gg, Gg, Gg, Ww, Ww, Gg, Gg, Gg, Gg^Vh, Ww, Gg, Gg, Gg, Gg^Fp, Gg, Gg, Gg, Gg, Gg, Gg^Fp, Rr, Rr, Gg^Fp
Gg^Fp, Gg^Fp, Gg, Gg, Gg, Gg, Gg, Gg, Gg, Gg, Gg, Gg^Fp, Gg, Gg, Gg, Gg, Gg, Ww, Ww, Ww, Ww, Gg, Ww, Ww, Gg, Gg^Fp, Gg^Fp, Gg^Fp, Gg, Gg, Gg, Gg, Gg, Gg, Gg^Fp, Gg^Fp, Gg^Fp, Rr
Gg^Fp, Gg^Fp, Gg, Gg, Gg, Gg, Gg, Gg, Gg, Gg, Gg^Fp, Gg, Gg, Gg, Gg, Gg, Gg, Ww, Ww, Ww, Ww, Ww, Ww, Ww, Gg, Gg, Gg, Gg, Gg, Gg, Gg, Gg, Gg, Gg^Fp, Gg, Gg, Gg^Fp, Rr
Gg, Gg, Gg, Gg, Gg, Gg, Gg, Gg, Gg, Gg^Fp, Gg, Gg, Gg, Gg, Gg, Gg, Ww, Ww, Ww, Ww, Ww, Hh, Gg, Gg, Gg, Gg, Gg, Gg, Gg, Gg, Gg, Gg, Gg^Fp, Gg, Gg, Gg^Fp, Rr, Rr
Gg, Gg, Gg, Gg, Gg, Gg, Gg, Gg, Gg, Gg, Gg, Gg, Gg, Gg, Gg, Gg, Ww, Hh^Vhh, Ww, Ww, Ww, Ww, Ww, Ww, Gg, Gg, Gg, Gg, Gg, Gg, Gg, Gg, Gg^Fp, Gg, Gg^Fp, Rr, Gg, Gg
Gg^Fp, Gg^Fp, Gg, Gg, Gg, Gg, Gg, Gg^Fp, Gg, Gg, Gg, Gg, Gg, Gg, Gg, Gg, Ww, Hh, Ww, Ww, Ww, Ww, Ww, Ww, Gg, Gg, Gg, Gg, Gg, Gg, Gg, Gg^Fp, Gg^Ve, Gg^Fp, Gg^Fp, Rr, Gg, Gs
Hh, Hh, Gg, Gg, Gg^Vh, Gg, Gg, Gg, Gg, Gg, Gg, Gg^Fp, Gg^Fp, Gg^Fp, Gg, Gg^Fp, Ww, Ww, Ww, Ww, Ww, Ww, Ww, Ww, Gg, Gg, Gg, Gg, Gg, Gg, Gg^Fp, Gg^Fp, Gg^Fp, Gg^Fp, Gg, Rr, Gg^Vh, Gs
Hh, Hh, Hh, Gg^Fp, Gg, Gg^Fp, Gg, Gg, Gg, Gg, Gg, Ss, Ss, Gg, Gg^Fp, Gg^Vh, Ww, Ww, Ww, Ww, Ww, Ww, Ww, Gg^Vh, Gg, Gg, Gg, Gg, Gg, Gg, Gg^Fp, Gg^Fp, Gg^Fp, Gg^Fp, Rr, Rr, Gg, Gs
Hh, Hh, Mm, Hh, Gg^Fp, Gg^Fp, Gg^Fp, Gg, Gg, Gg, Gg^Fp, Gg, Gg, Gg, Gg, Gg^Fp, Ww, Ww, Ww, Ww, Ww, Ww, Ww, Gg, Gg, Gg, Gg, Gg, Gg, Gg, Gg, Gg, Rr, Rr, Gg, Gg, Gg, Gg
Hh, Hh, Mm, Mm, Hh, Gg, Gg^Fp, Gg^Fp, Gg, Gg, Gg^Fp, Gg^Fp, Gg, Gg, Gg, Gg, Hh, Ww, Hh, Hh^Vhh, Ww, Ww, Ww, Gg, Gg, Hh, Hh, Gg, Gg, Gg, Rr, Rr, Gg, Gg, Gg, Gg, Gg, Gg
Gg, Gg, Hh, Mm, Gg, Gg, Gg^Fp, Gg^Fp, Gg, Gg, Gg^Fp, Ss, Gg, Gg, Gg, Gg^Fp, Gg, Hh, Hh, Hh, Hh, Hh, Ww, Gg, Gg, Hh, Gg, Gg, Gg, Rr, Gg, Gg, Gg, Gg, Gg, Gg, Gg, Gg
